Font Chef Table TSI5

\#0	Other
A	UpperCase
Aacute	UpperCase
Abreve	UpperCase
Abreveacute	UpperCase
Abrevedotbelow	UpperCase
Abrevegrave	UpperCase
Abrevehookabove	UpperCase
Abrevetilde	UpperCase
Acircumflex	UpperCase
Acircumflexacute	UpperCase
Acircumflexdotbelow	UpperCase
Acircumflexgrave	UpperCase
Acircumflexhookabove	UpperCase
Acircumflextilde	UpperCase
Adieresis	UpperCase
Adotbelow	UpperCase
Agrave	UpperCase
Ahookabove	UpperCase
Amacron	UpperCase
Aogonek	UpperCase
Aring	UpperCase
Aringacute	UpperCase
Aringbelow	UpperCase
Atilde	UpperCase
AE	UpperCase
AEacute	UpperCase
B	UpperCase
C	UpperCase
Cacute	UpperCase
Ccaron	UpperCase
Ccedilla	UpperCase
Ccircumflex	UpperCase
Cdotaccent	UpperCase
D	UpperCase
Eth	UpperCase
Dcaron	UpperCase
Dcroat	UpperCase
E	UpperCase
Eacute	UpperCase
Ebreve	UpperCase
Ecaron	UpperCase
Ecircumflex	UpperCase
Ecircumflexacute	UpperCase
Ecircumflexdotbelow	UpperCase
Ecircumflexgrave	UpperCase
Ecircumflexhookabove	UpperCase
Ecircumflextilde	UpperCase
Edieresis	UpperCase
Edotaccent	UpperCase
Edotbelow	UpperCase
Egrave	UpperCase
Ehookabove	UpperCase
Emacron	UpperCase
Eogonek	UpperCase
Etilde	UpperCase
F	UpperCase
G	UpperCase
Gbreve	UpperCase
Gcircumflex	UpperCase
Gcommaaccent	UpperCase
Gdotaccent	UpperCase
H	UpperCase
Hbar	UpperCase
Hcircumflex	UpperCase
I	UpperCase
IJ	UpperCase
Iacute	UpperCase
Ibreve	UpperCase
Icircumflex	UpperCase
Idieresis	UpperCase
Idotaccent	UpperCase
Idotbelow	UpperCase
Igrave	UpperCase
Ihookabove	UpperCase
Imacron	UpperCase
Iogonek	UpperCase
Itilde	UpperCase
J	UpperCase
Jcircumflex	UpperCase
K	UpperCase
Kcommaaccent	UpperCase
L	UpperCase
Lacute	UpperCase
Lcaron	UpperCase
Lcommaaccent	UpperCase
Ldot	UpperCase
Lslash	UpperCase
M	UpperCase
Macute	UpperCase
N	UpperCase
Nacute	UpperCase
Ncaron	UpperCase
Ncommaaccent	UpperCase
Eng	UpperCase
Ntilde	UpperCase
O	UpperCase
Oacute	UpperCase
Obreve	UpperCase
Ocircumflex	UpperCase
Ocircumflexacute	UpperCase
Ocircumflexdotbelow	UpperCase
Ocircumflexgrave	UpperCase
Ocircumflexhookabove	UpperCase
Ocircumflextilde	UpperCase
Odieresis	UpperCase
Odotbelow	UpperCase
Ograve	UpperCase
Ohookabove	UpperCase
Ohorn	UpperCase
Ohornacute	UpperCase
Ohorndotbelow	UpperCase
Ohorngrave	UpperCase
Ohornhookabove	UpperCase
Ohorntilde	UpperCase
Ohungarumlaut	UpperCase
Omacron	UpperCase
Oslash	UpperCase
Oslashacute	UpperCase
Otilde	UpperCase
OE	UpperCase
P	UpperCase
Thorn	UpperCase
Q	UpperCase
R	UpperCase
Racute	UpperCase
Rcaron	UpperCase
Rcommaaccent	UpperCase
S	UpperCase
Sacute	UpperCase
Scaron	UpperCase
Scedilla	UpperCase
Scircumflex	UpperCase
Scommaaccent	UpperCase
Germandbls	UpperCase
T	UpperCase
Tbar	UpperCase
Tcaron	UpperCase
Tcedilla	UpperCase
Tcommaaccent	UpperCase
U	UpperCase
Uacute	UpperCase
Ubreve	UpperCase
Ucircumflex	UpperCase
Udieresis	UpperCase
Udotbelow	UpperCase
Ugrave	UpperCase
Uhookabove	UpperCase
Uhorn	UpperCase
Uhornacute	UpperCase
Uhorndotbelow	UpperCase
Uhorngrave	UpperCase
Uhornhookabove	UpperCase
Uhorntilde	UpperCase
Uhungarumlaut	UpperCase
Umacron	UpperCase
Uogonek	UpperCase
Uring	UpperCase
Utilde	UpperCase
V	UpperCase
W	UpperCase
Wacute	UpperCase
Wcircumflex	UpperCase
Wdieresis	UpperCase
Wgrave	UpperCase
X	UpperCase
Y	UpperCase
Yacute	UpperCase
Ycircumflex	UpperCase
Ydieresis	UpperCase
Ydotbelow	UpperCase
Ygrave	UpperCase
Yhookabove	UpperCase
Ytilde	UpperCase
Z	UpperCase
Zacute	UpperCase
Zcaron	UpperCase
Zdotaccent	UpperCase
Aringacute.rvrn	UpperCase
I.ss01	UpperCase
IJ.ss01	UpperCase
Iacute.ss01	UpperCase
Ibreve.ss01	UpperCase
Icircumflex.ss01	UpperCase
Idieresis.ss01	UpperCase
Idotaccent.ss01	UpperCase
Idotbelow.ss01	UpperCase
Igrave.ss01	UpperCase
Ihookabove.ss01	UpperCase
Imacron.ss01	UpperCase
Iogonek.ss01	UpperCase
Itilde.ss01	UpperCase
a	LowerCase
aacute	LowerCase
abreve	LowerCase
abreveacute	LowerCase
abrevedotbelow	LowerCase
abrevegrave	LowerCase
abrevehookabove	LowerCase
abrevetilde	LowerCase
acircumflex	LowerCase
acircumflexacute	LowerCase
acircumflexdotbelow	LowerCase
acircumflexgrave	LowerCase
acircumflexhookabove	LowerCase
acircumflextilde	LowerCase
adieresis	LowerCase
adotbelow	LowerCase
agrave	LowerCase
ahookabove	LowerCase
amacron	LowerCase
aogonek	LowerCase
aring	LowerCase
aringacute	LowerCase
aringbelow	LowerCase
atilde	LowerCase
ae	LowerCase
aeacute	LowerCase
b	LowerCase
c	LowerCase
cacute	LowerCase
ccaron	LowerCase
ccedilla	LowerCase
ccircumflex	LowerCase
cdotaccent	LowerCase
d	LowerCase
eth	LowerCase
dcaron	LowerCase
dcroat	LowerCase
e	LowerCase
eacute	LowerCase
ebreve	LowerCase
ecaron	LowerCase
ecircumflex	LowerCase
ecircumflexacute	LowerCase
ecircumflexdotbelow	LowerCase
ecircumflexgrave	LowerCase
ecircumflexhookabove	LowerCase
ecircumflextilde	LowerCase
edieresis	LowerCase
edotaccent	LowerCase
edotbelow	LowerCase
egrave	LowerCase
ehookabove	LowerCase
emacron	LowerCase
eogonek	LowerCase
etilde	LowerCase
f	LowerCase
g	LowerCase
gbreve	LowerCase
gcircumflex	LowerCase
gcommaaccent	LowerCase
gdotaccent	LowerCase
h	LowerCase
hbar	LowerCase
hcircumflex	LowerCase
i	LowerCase
idotless	LowerCase
iacute	LowerCase
ibreve	LowerCase
icircumflex	LowerCase
idieresis	LowerCase
idotbelow	LowerCase
igrave	LowerCase
ihookabove	LowerCase
ij	LowerCase
imacron	LowerCase
iogonek	LowerCase
itilde	LowerCase
j	LowerCase
jdotless	LowerCase
jcaron	LowerCase
jcircumflex	LowerCase
k	LowerCase
kcommaaccent	LowerCase
kgreenlandic	LowerCase
l	LowerCase
lacute	LowerCase
lcaron	LowerCase
lcommaaccent	LowerCase
ldot	LowerCase
lslash	LowerCase
m	LowerCase
macute	LowerCase
n	LowerCase
nacute	LowerCase
napostrophe	LowerCase
ncaron	LowerCase
ncommaaccent	LowerCase
eng	LowerCase
ntilde	LowerCase
o	LowerCase
oacute	LowerCase
obreve	LowerCase
ocircumflex	LowerCase
ocircumflexacute	LowerCase
ocircumflexdotbelow	LowerCase
ocircumflexgrave	LowerCase
ocircumflexhookabove	LowerCase
ocircumflextilde	LowerCase
odieresis	LowerCase
odotbelow	LowerCase
ograve	LowerCase
ohookabove	LowerCase
ohorn	LowerCase
ohornacute	LowerCase
ohorndotbelow	LowerCase
ohorngrave	LowerCase
ohornhookabove	LowerCase
ohorntilde	LowerCase
ohungarumlaut	LowerCase
omacron	LowerCase
oslash	LowerCase
oslashacute	LowerCase
otilde	LowerCase
oe	LowerCase
p	LowerCase
thorn	LowerCase
q	LowerCase
r	LowerCase
racute	LowerCase
rcaron	LowerCase
rcommaaccent	LowerCase
s	LowerCase
sacute	LowerCase
scaron	LowerCase
scedilla	LowerCase
scircumflex	LowerCase
scommaaccent	LowerCase
germandbls	LowerCase
longs	LowerCase
t	LowerCase
tbar	LowerCase
tcaron	LowerCase
tcedilla	LowerCase
tcommaaccent	LowerCase
u	LowerCase
uacute	LowerCase
ubreve	LowerCase
ucircumflex	LowerCase
udieresis	LowerCase
udotbelow	LowerCase
ugrave	LowerCase
uhookabove	LowerCase
uhorn	LowerCase
uhornacute	LowerCase
uhorndotbelow	LowerCase
uhorngrave	LowerCase
uhornhookabove	LowerCase
uhorntilde	LowerCase
uhungarumlaut	LowerCase
umacron	LowerCase
uogonek	LowerCase
uring	LowerCase
utilde	LowerCase
v	LowerCase
w	LowerCase
wacute	LowerCase
wcircumflex	LowerCase
wdieresis	LowerCase
wgrave	LowerCase
x	LowerCase
y	LowerCase
yacute	LowerCase
ycircumflex	LowerCase
ydieresis	LowerCase
ydotbelow	LowerCase
ygrave	LowerCase
yhookabove	LowerCase
ytilde	LowerCase
z	LowerCase
zacute	LowerCase
zcaron	LowerCase
zdotaccent	LowerCase
c.rvrn	LowerCase
g.ss02	LowerCase
gbreve.ss02	LowerCase
gcircumflex.ss02	LowerCase
gcommaaccent.ss02	LowerCase
gdotaccent.ss02	LowerCase
f_f	LowerCase
f_f_i	LowerCase
f_f_l	LowerCase
fi	LowerCase
fl	LowerCase
ordfeminine	Other
ordmasculine	Other
nmod	Other
A-cy	UpperCase
Be-cy	UpperCase
Ve-cy	UpperCase
Ge-cy	UpperCase
Gje-cy	UpperCase
Gheupturn-cy	UpperCase
De-cy	UpperCase
Ie-cy	UpperCase
Iegrave-cy	UpperCase
Io-cy	UpperCase
Zhe-cy	UpperCase
Ze-cy	UpperCase
Ii-cy	UpperCase
Iishort-cy	UpperCase
Iigrave-cy	UpperCase
Iishorttail-cy	UpperCase
Ka-cy	UpperCase
Kje-cy	UpperCase
El-cy	UpperCase
Em-cy	UpperCase
En-cy	UpperCase
O-cy	UpperCase
Pe-cy	UpperCase
Er-cy	UpperCase
Es-cy	UpperCase
Te-cy	UpperCase
U-cy	UpperCase
Ushort-cy	UpperCase
Ef-cy	UpperCase
Ha-cy	UpperCase
Che-cy	UpperCase
Tse-cy	UpperCase
Sha-cy	UpperCase
Shcha-cy	UpperCase
Dzhe-cy	UpperCase
Softsign-cy	UpperCase
Hardsign-cy	UpperCase
Yeru-cy	UpperCase
Lje-cy	UpperCase
Nje-cy	UpperCase
Dze-cy	UpperCase
E-cy	UpperCase
Ereversed-cy	UpperCase
I-cy	UpperCase
Yi-cy	UpperCase
Je-cy	UpperCase
Tshe-cy	UpperCase
Iu-cy	UpperCase
Ia-cy	UpperCase
Dje-cy	UpperCase
Omega-cy	UpperCase
Yat-cy	UpperCase
Eiotified-cy	UpperCase
Yuslittle-cy	UpperCase
Yuslittleiotified-cy	UpperCase
Yusbig-cy	UpperCase
Yusbigiotified-cy	UpperCase
Ksi-cy	UpperCase
Psi-cy	UpperCase
Fita-cy	UpperCase
Izhitsa-cy	UpperCase
Izhitsadblgrave-cy	UpperCase
Uk-cy	UpperCase
Ghestroke-cy	UpperCase
Ghemiddlehook-cy	UpperCase
Zhedescender-cy	UpperCase
Zedescender-cy	UpperCase
Kadescender-cy	UpperCase
Kaverticalstroke-cy	UpperCase
Kastroke-cy	UpperCase
Kabashkir-cy	UpperCase
Endescender-cy	UpperCase
Enghe-cy	UpperCase
Pemiddlehook-cy	UpperCase
Haabkhasian-cy	UpperCase
Esdescender-cy	UpperCase
Tedescender-cy	UpperCase
Ustrait-cy	UpperCase
Ustraitstroke-cy	UpperCase
Hadescender-cy	UpperCase
Tetse-cy	UpperCase
Chedescender-cy	UpperCase
Cheverticalstroke-cy	UpperCase
Shha-cy	UpperCase
Cheabkhasian-cy	UpperCase
Chedescenderabkhasian-cy	UpperCase
Palochka-cy	UpperCase
Zhebreve-cy	UpperCase
Kahook-cy	UpperCase
Eltail-cy	UpperCase
Enhook-cy	UpperCase
Entail-cy	UpperCase
Chekhakassian-cy	UpperCase
Emtail-cy	UpperCase
Abreve-cy	UpperCase
Adieresis-cy	UpperCase
Aie-cy	UpperCase
Iebreve-cy	UpperCase
Schwa-cy	UpperCase
Schwadieresis-cy	UpperCase
Zhedieresis-cy	UpperCase
Zedieresis-cy	UpperCase
Dzeabkhasian-cy	UpperCase
Imacron-cy	UpperCase
Idieresis-cy	UpperCase
Odieresis-cy	UpperCase
Obarred-cy	UpperCase
Obarreddieresis-cy	UpperCase
Edieresis-cy	UpperCase
Umacron-cy	UpperCase
Udieresis-cy	UpperCase
Uhungarumlaut-cy	UpperCase
Chedieresis-cy	UpperCase
Gedescender-cy	UpperCase
Yerudieresis-cy	UpperCase
Gestrokehook-cy	UpperCase
Hahook-cy	UpperCase
Hastroke-cy	UpperCase
Komide-cy	UpperCase
Komidje-cy	UpperCase
Komizje-cy	UpperCase
Komidzje-cy	UpperCase
Komilje-cy	UpperCase
Kominje-cy	UpperCase
Komisje-cy	UpperCase
Komitje-cy	UpperCase
Reversedze-cy	UpperCase
Elhook-cy	UpperCase
Koppa-cy	UpperCase
Semisoftsign-cy	UpperCase
Ertick-cy	UpperCase
uni047C.rvrn	UpperCase
I-cy.ss01	UpperCase
Yi-cy.ss01	UpperCase
Palochka-cy.ss01	Other
a-cy	LowerCase
be-cy	LowerCase
ve-cy	LowerCase
ge-cy	LowerCase
gje-cy	LowerCase
gheupturn-cy	LowerCase
de-cy	LowerCase
ie-cy	LowerCase
iegrave-cy	LowerCase
io-cy	LowerCase
zhe-cy	LowerCase
ze-cy	LowerCase
ii-cy	LowerCase
iishort-cy	LowerCase
iigrave-cy	LowerCase
iishorttail-cy	LowerCase
ka-cy	LowerCase
kje-cy	LowerCase
el-cy	LowerCase
em-cy	LowerCase
en-cy	LowerCase
o-cy	LowerCase
pe-cy	LowerCase
er-cy	LowerCase
es-cy	LowerCase
te-cy	LowerCase
u-cy	LowerCase
ushort-cy	LowerCase
ef-cy	LowerCase
ha-cy	LowerCase
che-cy	LowerCase
tse-cy	LowerCase
sha-cy	LowerCase
shcha-cy	LowerCase
dzhe-cy	LowerCase
softsign-cy	LowerCase
hardsign-cy	LowerCase
yeru-cy	LowerCase
lje-cy	LowerCase
nje-cy	LowerCase
dze-cy	LowerCase
e-cy	LowerCase
ereversed-cy	LowerCase
i-cy	LowerCase
yi-cy	LowerCase
je-cy	LowerCase
tshe-cy	LowerCase
iu-cy	LowerCase
ia-cy	LowerCase
dje-cy	LowerCase
omega-cy	LowerCase
yat-cy	LowerCase
eiotified-cy	LowerCase
yuslittle-cy	LowerCase
yuslittleiotified-cy	LowerCase
yusbig-cy	LowerCase
yusbigiotified-cy	LowerCase
ksi-cy	LowerCase
psi-cy	LowerCase
fita-cy	LowerCase
izhitsa-cy	LowerCase
izhitsadblgrave-cy	LowerCase
uk-cy	LowerCase
ghestroke-cy	LowerCase
ghemiddlehook-cy	LowerCase
zhedescender-cy	LowerCase
zedescender-cy	LowerCase
kadescender-cy	LowerCase
kaverticalstroke-cy	LowerCase
kastroke-cy	LowerCase
kabashkir-cy	LowerCase
endescender-cy	LowerCase
enghe-cy	LowerCase
pemiddlehook-cy	LowerCase
haabkhasian-cy	LowerCase
esdescender-cy	LowerCase
tedescender-cy	LowerCase
ustrait-cy	LowerCase
ustraitstroke-cy	LowerCase
hadescender-cy	LowerCase
tetse-cy	LowerCase
chedescender-cy	LowerCase
cheverticalstroke-cy	LowerCase
shha-cy	LowerCase
cheabkhasian-cy	LowerCase
chedescenderabkhasian-cy	LowerCase
palochka-cy	LowerCase
zhebreve-cy	LowerCase
kahook-cy	LowerCase
eltail-cy	LowerCase
enhook-cy	LowerCase
entail-cy	LowerCase
chekhakassian-cy	LowerCase
emtail-cy	LowerCase
abreve-cy	LowerCase
adieresis-cy	LowerCase
aie-cy	LowerCase
iebreve-cy	LowerCase
schwa-cy	LowerCase
schwadieresis-cy	LowerCase
zhedieresis-cy	LowerCase
zedieresis-cy	LowerCase
dzeabkhasian-cy	LowerCase
imacron-cy	LowerCase
idieresis-cy	LowerCase
odieresis-cy	LowerCase
obarred-cy	LowerCase
obarreddieresis-cy	LowerCase
edieresis-cy	LowerCase
umacron-cy	LowerCase
udieresis-cy	LowerCase
uhungarumlaut-cy	LowerCase
chedieresis-cy	LowerCase
gedescender-cy	LowerCase
yerudieresis-cy	LowerCase
gestrokehook-cy	LowerCase
hahook-cy	LowerCase
hastroke-cy	LowerCase
komide-cy	LowerCase
komidje-cy	LowerCase
komizje-cy	LowerCase
komidzje-cy	LowerCase
komilje-cy	LowerCase
kominje-cy	LowerCase
komisje-cy	LowerCase
komitje-cy	LowerCase
reversedze-cy	LowerCase
elhook-cy	LowerCase
koppa-cy	LowerCase
semisoftsign-cy	LowerCase
ertick-cy	LowerCase
palochka-cy.ss01	LowerCase
Alpha	UpperCase
Beta	UpperCase
Gamma	UpperCase
Delta	UpperCase
Epsilon	UpperCase
Zeta	UpperCase
Eta	UpperCase
Theta	UpperCase
Iota	UpperCase
Kappa	UpperCase
Lambda	UpperCase
Mu	UpperCase
Nu	UpperCase
Xi	UpperCase
Omicron	UpperCase
Pi	UpperCase
Rho	UpperCase
Sigma	UpperCase
Tau	UpperCase
Upsilon	UpperCase
Phi	UpperCase
Chi	UpperCase
Psi	UpperCase
Omega	UpperCase
Alphatonos	UpperCase
Epsilontonos	UpperCase
Etatonos	UpperCase
Iotatonos	UpperCase
Omicrontonos	UpperCase
Upsilontonos	UpperCase
Omegatonos	UpperCase
Iotadieresis	UpperCase
Upsilondieresis	UpperCase
UpsilonhookSymbol	UpperCase
ThetaSymbol	UpperCase
Omicrondasiaoxia	UpperCase
Iota.ss01	UpperCase
Iotatonos.ss01	UpperCase
Iotadieresis.ss01	UpperCase
alpha	LowerCase
beta	LowerCase
gamma	LowerCase
delta	LowerCase
epsilon	LowerCase
zeta	LowerCase
eta	LowerCase
theta	LowerCase
iota	LowerCase
kappa	LowerCase
lambda	LowerCase
mu	LowerCase
nu	LowerCase
xi	LowerCase
omicron	LowerCase
pi	LowerCase
rho	LowerCase
sigmafinal	LowerCase
sigma	LowerCase
tau	LowerCase
upsilon	LowerCase
phi	LowerCase
chi	LowerCase
psi	LowerCase
omega	LowerCase
iotatonos	LowerCase
iotadieresis	LowerCase
iotadieresistonos	LowerCase
upsilontonos	LowerCase
upsilondieresis	LowerCase
upsilondieresistonos	LowerCase
omicrontonos	LowerCase
omegatonos	LowerCase
alphatonos	LowerCase
epsilontonos	LowerCase
etatonos	LowerCase
thetaSymbol	LowerCase
phiSymbol	LowerCase
piSymbol	LowerCase
kappaSymbol	LowerCase
rhoSymbol	LowerCase
epsilonLunateSymbol	LowerCase
A-fraktur	Other
ABold-fraktur	Other
B-fraktur	Other
BBold-fraktur	Other
C-fraktur	Other
CBold-fraktur	Other
D-fraktur	Other
DBold-fraktur	Other
E-fraktur	Other
EBold-fraktur	Other
F-fraktur	Other
FBold-fraktur	Other
G-fraktur	Other
GBold-fraktur	Other
H-fraktur	Other
HBold-fraktur	Other
I-fraktur	Other
IBold-fraktur	Other
J-fraktur	Other
JBold-fraktur	Other
K-fraktur	Other
KBold-fraktur	Other
L-fraktur	Other
LBold-fraktur	Other
M-fraktur	Other
MBold-fraktur	Other
N-fraktur	Other
NBold-fraktur	Other
O-fraktur	Other
OBold-fraktur	Other
P-fraktur	Other
PBold-fraktur	Other
Q-fraktur	Other
QBold-fraktur	Other
R-fraktur	Other
RBold-fraktur	Other
S-fraktur	Other
SBold-fraktur	Other
T-fraktur	Other
TBold-fraktur	Other
U-fraktur	Other
UBold-fraktur	Other
V-fraktur	Other
VBold-fraktur	Other
W-fraktur	Other
WBold-fraktur	Other
X-fraktur	Other
XBold-fraktur	Other
Y-fraktur	Other
YBold-fraktur	Other
Z-fraktur	Other
ZBold-fraktur	Other
a-fraktur	Other
aBold-fraktur	Other
b-fraktur	Other
bBold-fraktur	Other
c-fraktur	Other
cBold-fraktur	Other
d-fraktur	Other
dBold-fraktur	Other
e-fraktur	Other
eBold-fraktur	Other
f-fraktur	Other
fBold-fraktur	Other
g-fraktur	Other
gBold-fraktur	Other
h-fraktur	Other
hBold-fraktur	Other
i-fraktur	Other
iBold-fraktur	Other
j-fraktur	Other
jBold-fraktur	Other
k-fraktur	Other
kBold-fraktur	Other
l-fraktur	Other
lBold-fraktur	Other
m-fraktur	Other
mBold-fraktur	Other
n-fraktur	Other
nBold-fraktur	Other
o-fraktur	Other
oBold-fraktur	Other
p-fraktur	Other
pBold-fraktur	Other
q-fraktur	Other
qBold-fraktur	Other
r-fraktur	Other
rBold-fraktur	Other
s-fraktur	Other
sBold-fraktur	Other
t-fraktur	Other
tBold-fraktur	Other
u-fraktur	Other
uBold-fraktur	Other
v-fraktur	Other
vBold-fraktur	Other
w-fraktur	Other
wBold-fraktur	Other
x-fraktur	Other
xBold-fraktur	Other
y-fraktur	Other
yBold-fraktur	Other
z-fraktur	Other
zBold-fraktur	Other
alef-hb	Hebrew
alefpatah-hb	Hebrew
alefqamats-hb	Hebrew
alefdagesh-hb	Hebrew
bet-hb	Hebrew
betdagesh-hb	Hebrew
gimel-hb	Hebrew
gimeldagesh-hb	Hebrew
dalet-hb	Hebrew
daletdagesh-hb	Hebrew
he-hb	Hebrew
hedagesh-hb	Hebrew
vav-hb	Hebrew
vavdagesh-hb	Hebrew
vavholam-hb	Hebrew
zayin-hb	Hebrew
zayindagesh-hb	Hebrew
het-hb	Hebrew
tet-hb	Hebrew
tetdagesh-hb	Hebrew
yod-hb	Hebrew
yoddagesh-hb	Hebrew
finalkaf-hb	Hebrew
finalkafdagesh-hb	Hebrew
kaf-hb	Hebrew
kafdagesh-hb	Hebrew
lamed-hb	Hebrew
lameddagesh-hb	Hebrew
finalmem-hb	Hebrew
mem-hb	Hebrew
memdagesh-hb	Hebrew
finalnun-hb	Hebrew
nun-hb	Hebrew
nundagesh-hb	Hebrew
samekh-hb	Hebrew
samekhdagesh-hb	Hebrew
ayin-hb	Hebrew
finalpe-hb	Hebrew
finalpedagesh-hb	Hebrew
pe-hb	Hebrew
pedagesh-hb	Hebrew
finaltsadi-hb	Hebrew
tsadi-hb	Hebrew
tsadidagesh-hb	Hebrew
qof-hb	Hebrew
qofdagesh-hb	Hebrew
resh-hb	Hebrew
reshdagesh-hb	Hebrew
shin-hb	Hebrew
shinshindot-hb	Hebrew
shinsindot-hb	Hebrew
shindageshshindot-hb	Hebrew
shindageshsindot-hb	Hebrew
shindagesh-hb	Hebrew
tav-hb	Hebrew
tavdagesh-hb	Hebrew
alefdagesh-hb.rvrn	Hebrew
hedagesh-hb.rvrn	Hebrew
finalpedagesh-hb.rvrn	Hebrew
pedagesh-hb.rvrn	Hebrew
qofdagesh-hb.rvrn	Hebrew
shindageshshindot-hb.rvrn	Hebrew
shindageshsindot-hb.rvrn	Hebrew
shindagesh-hb.rvrn	Hebrew
tavdagesh-hb.rvrn	Hebrew
Abold-math	Other
Abolditalic-math	Other
Aboldscript-math	Other
Aitalic-math	Other
Ascript-math	Other
Bbold-math	Other
Bbolditalic-math	Other
Bboldscript-math	Other
Bitalic-math	Other
Cbold-math	Other
Cbolditalic-math	Other
Cboldscript-math	Other
Citalic-math	Other
Cscript-math	Other
Dbold-math	Other
Dbolditalic-math	Other
Dboldscript-math	Other
Ditalic-math	Other
Dscript-math	Other
Ebold-math	Other
Ebolditalic-math	Other
Eboldscript-math	Other
Eitalic-math	Other
Fbold-math	Other
Fbolditalic-math	Other
Fboldscript-math	Other
Fitalic-math	Other
Gbold-math	Other
Gbolditalic-math	Other
Gboldscript-math	Other
Gitalic-math	Other
Gscript-math	Other
Hbold-math	Other
Hbolditalic-math	Other
Hboldscript-math	Other
Hitalic-math	Other
Ibold-math	Other
Ibolditalic-math	Other
Iboldscript-math	Other
Iitalic-math	Other
Jbold-math	Other
Jbolditalic-math	Other
Jboldscript-math	Other
Jitalic-math	Other
Jscript-math	Other
Kbold-math	Other
Kbolditalic-math	Other
Kboldscript-math	Other
Kitalic-math	Other
Kscript-math	Other
Lbold-math	Other
Lbolditalic-math	Other
Lboldscript-math	Other
Litalic-math	Other
Mbold-math	Other
Mbolditalic-math	Other
Mboldscript-math	Other
Mitalic-math	Other
Nbold-math	Other
Nbolditalic-math	Other
Nboldscript-math	Other
Nitalic-math	Other
Nscript-math	Other
Obold-math	Other
Obolditalic-math	Other
Oboldscript-math	Other
Oitalic-math	Other
Oscript-math	Other
Pbold-math	Other
Pbolditalic-math	Other
Pboldscript-math	Other
Pitalic-math	Other
Pscript-math	Other
Qbold-math	Other
Qbolditalic-math	Other
Qboldscript-math	Other
Qitalic-math	Other
Qscript-math	Other
Rbold-math	Other
Rbolditalic-math	Other
Rboldscript-math	Other
Ritalic-math	Other
Sbold-math	Other
Sbolditalic-math	Other
Sboldscript-math	Other
Sitalic-math	Other
Sscript-math	Other
Tbold-math	Other
Tbolditalic-math	Other
Tboldscript-math	Other
Titalic-math	Other
Tscript-math	Other
Ubold-math	Other
Ubolditalic-math	Other
Uboldscript-math	Other
Uitalic-math	Other
Uscript-math	Other
Vbold-math	Other
Vbolditalic-math	Other
Vboldscript-math	Other
Vitalic-math	Other
Vscript-math	Other
Wbold-math	Other
Wbolditalic-math	Other
Wboldscript-math	Other
Witalic-math	Other
Wscript-math	Other
Xbold-math	Other
Xbolditalic-math	Other
Xboldscript-math	Other
Xitalic-math	Other
Xscript-math	Other
Ybold-math	Other
Ybolditalic-math	Other
Yboldscript-math	Other
Yitalic-math	Other
Yscript-math	Other
Zbold-math	Other
Zbolditalic-math	Other
Zboldscript-math	Other
Zitalic-math	Other
Zscript-math	Other
abold-math	Other
abolditalic-math	Other
aboldscript-math	Other
aitalic-math	Other
ascript-math	Other
bbold-math	Other
bbolditalic-math	Other
bboldscript-math	Other
bitalic-math	Other
bscript-math	Other
cbold-math	Other
cbolditalic-math	Other
cboldscript-math	Other
citalic-math	Other
cscript-math	Other
dbold-math	Other
dbolditalic-math	Other
dboldscript-math	Other
ditalic-math	Other
dscript-math	Other
ebold-math	Other
ebolditalic-math	Other
eboldscript-math	Other
eitalic-math	Other
fbold-math	Other
fbolditalic-math	Other
fboldscript-math	Other
fitalic-math	Other
fscript-math	Other
gbold-math	Other
gbolditalic-math	Other
gboldscript-math	Other
gitalic-math	Other
hbold-math	Other
hbolditalic-math	Other
hboldscript-math	Other
hscript-math	Other
ibold-math	Other
ibolditalic-math	Other
iboldscript-math	Other
iitalic-math	Other
iscript-math	Other
jbold-math	Other
jbolditalic-math	Other
jboldscript-math	Other
jitalic-math	Other
jscript-math	Other
kbold-math	Other
kbolditalic-math	Other
kboldscript-math	Other
kitalic-math	Other
kscript-math	Other
lbold-math	Other
lbolditalic-math	Other
lboldscript-math	Other
litalic-math	Other
lscript-math	Other
mbold-math	Other
mbolditalic-math	Other
mboldscript-math	Other
mitalic-math	Other
mscript-math	Other
nbold-math	Other
nbolditalic-math	Other
nboldscript-math	Other
nitalic-math	Other
nscript-math	Other
obold-math	Other
obolditalic-math	Other
oboldscript-math	Other
oitalic-math	Other
pbold-math	Other
pbolditalic-math	Other
pboldscript-math	Other
pitalic-math	Other
pscript-math	Other
qbold-math	Other
qbolditalic-math	Other
qboldscript-math	Other
qitalic-math	Other
qscript-math	Other
rbold-math	Other
rbolditalic-math	Other
rboldscript-math	Other
ritalic-math	Other
rscript-math	Other
sbold-math	Other
sbolditalic-math	Other
sboldscript-math	Other
sitalic-math	Other
sscript-math	Other
tbold-math	Other
tbolditalic-math	Other
tboldscript-math	Other
titalic-math	Other
tscript-math	Other
ubold-math	Other
ubolditalic-math	Other
uboldscript-math	Other
uitalic-math	Other
uscript-math	Other
vbold-math	Other
vbolditalic-math	Other
vboldscript-math	Other
vitalic-math	Other
vscript-math	Other
wbold-math	Other
wbolditalic-math	Other
wboldscript-math	Other
witalic-math	Other
wscript-math	Other
xbold-math	Other
xbolditalic-math	Other
xboldscript-math	Other
xitalic-math	Other
xscript-math	Other
ybold-math	Other
ybolditalic-math	Other
yboldscript-math	Other
yitalic-math	Other
yscript-math	Other
zbold-math	Other
zbolditalic-math	Other
zboldscript-math	Other
zitalic-math	Other
zscript-math	Other
Bscript	Other
Hscript	Other
Iscript	Other
Lscript	Other
PidoubleStruck	Other
Rscript	Other
AdoubleStruck	Other
BdoubleStruck	Other
CdoubleStruck	Other
DdoubleStruck	Other
EdoubleStruck	Other
FdoubleStruck	Other
GdoubleStruck	Other
HdoubleStruck	Other
IdoubleStruck	Other
JdoubleStruck	Other
KdoubleStruck	Other
LdoubleStruck	Other
MdoubleStruck	Other
NdoubleStruck	Other
OdoubleStruck	Other
PdoubleStruck	Other
QdoubleStruck	Other
RdoubleStruck	Other
SdoubleStruck	Other
TdoubleStruck	Other
UdoubleStruck	Other
VdoubleStruck	Other
WdoubleStruck	Other
XdoubleStruck	Other
YdoubleStruck	Other
ZdoubleStruck	Other
DitalicDoubleStruck	Other
GammadoubleStruck	Other
Escript	Other
Fscript	Other
Mscript	Other
adoubleStruck	Other
bdoubleStruck	Other
cdoubleStruck	Other
ddoubleStruck	Other
edoubleStruck	Other
fdoubleStruck	Other
gdoubleStruck	Other
hdoubleStruck	Other
idoubleStruck	Other
jdoubleStruck	Other
kdoubleStruck	Other
ldoubleStruck	Other
mdoubleStruck	Other
ndoubleStruck	Other
odoubleStruck	Other
pdoubleStruck	Other
qdoubleStruck	Other
rdoubleStruck	Other
sdoubleStruck	Other
tdoubleStruck	Other
udoubleStruck	Other
vdoubleStruck	Other
wdoubleStruck	Other
xdoubleStruck	Other
ydoubleStruck	Other
zdoubleStruck	Other
ditalicDoubleStruck	Other
eitalicDoubleStruck	Other
iitalicDoubleStruck	Other
jitalicDoubleStruck	Other
gammadoubleStruck	Other
pidoubleStruck	Other
gscript	Other
planckconstant	Other
escript	Other
oscript	Other
zero	Figure
one	Figure
two	Figure
three	Figure
four	Figure
five	Figure
six	Figure
seven	Figure
eight	Figure
nine	Figure
one.paren	Other
two.paren	Other
one.lf	Figure
zero.osf	LowerCase
one.osf	LowerCase
two.osf	LowerCase
three.osf	LowerCase
four.osf	LowerCase
five.osf	LowerCase
six.osf	LowerCase
seven.osf	LowerCase
eight.osf	LowerCase
nine.osf	LowerCase
zero.dnom	Other
one.dnom	Other
two.dnom	Other
three.dnom	Other
four.dnom	Other
five.dnom	Other
six.dnom	Other
seven.dnom	Other
eight.dnom	Other
nine.dnom	Other
zero.numr	Other
one.numr	Other
two.numr	Other
three.numr	Other
four.numr	Other
five.numr	Other
six.numr	Other
seven.numr	Other
eight.numr	Other
nine.numr	Other
zerosuperior	Other
onesuperior	Other
twosuperior	Other
threesuperior	Other
foursuperior	Other
fivesuperior	Other
sixsuperior	Other
sevensuperior	Other
eightsuperior	Other
ninesuperior	Other
fraction	Other
onehalf	Other
onequarter	Other
threequarters	Other
oneeighth	Other
threeeighths	Other
fiveeighths	Other
seveneighths	Other
period	Other
comma	Other
colon	Other
semicolon	Other
ellipsis	Other
exclam	Other
exclamdown	Other
question	Other
questiondown	Other
periodcentered	Other
bullet	Other
asterisk	Other
exclamdouble	Other
numbersign	Other
slash	Other
backslash	Other
parenleft	Other
parenright	Other
braceleft	Other
braceright	Other
bracketleft	Other
bracketright	Other
braceleft.full	Other
braceright.full	Other
doubleleftarcgreaterthanbracket	Other
doublerightarclessthanbracket	Other
leftCeiling	Other
leftFloor	Other
leftanglebracketdot	Other
leftarclessthanbracket	Other
leftblacktortoiseshellbracket	Other
leftdoublewigglyfence	Other
leftpointingcurvedanglebracket	Other
leftsquarebrackettickinbottomcorner	Other
leftsquarebrackettickintopcorner	Other
leftsquarebracketunderbar	Other
leftsshapedbagdelimiter	Other
leftwhitecurlybracket	Other
leftwigglyfence	Other
rightCeiling	Other
rightFloor	Other
rightanglebracketdot	Other
rightarcgreaterthanbracket	Other
rightblacktortoiseshellbracket	Other
rightdoublewigglyfence	Other
rightpointingcurvedanglebracket	Other
rightsquarebrackettickinbottomcorner	Other
rightsquarebrackettickintopcorner	Other
rightsquarebracketunderbar	Other
rightsshapedbagdelimiter	Other
rightwhitecurlybracket	Other
rightwigglyfence	Other
whiteparenleft	Other
whiteparenright	Other
znotationleftbindingbracket	Other
znotationleftimagebracket	Other
znotationrightbindingbracket	Other
znotationrightimagebracket	Other
hyphen	Other
softhyphen	Other
endash	Other
emdash	Other
horizontalbar	Other
underscore	Other
underscoredbl	Other
quotesinglbase	Other
quotedblbase	Other
quotedblleft	Other
quotedblright	Other
quoteleft	Other
quoteright	Other
quotereversed	Other
doubleprimeReversed	Other
guillemetleft	Other
guillemetright	Other
guilsinglleft	Other
guilsinglright	Other
primeReversed	Other
quadrupleprime	Other
tripleprime	Other
tripleprimeReversed	Other
quotedbl	Other
quotesingle	Other
leftanglebracket-math	Other
leftdoubleanglebracket-math	Other
leftflattenedparenthesis-math	Other
leftwhitesquarebracket-math	Other
leftwhitetortoiseshellbracket-math	Other
rightanglebracket-math	Other
rightdoubleanglebracket-math	Other
rightflattenedparenthesis-math	Other
rightwhitesquarebracket-math	Other
rightwhitetortoiseshellbracket-math	Other
geresh-hb	Hebrew
gershayim-hb	Hebrew
maqaf-hb	Hebrew
anoteleia	Other
emquad	Other
emspace	Other
enquad	Other
enspace	Other
figurespace	Other
fourperemspace	Other
hairspace	Other
punctuationspace	Other
sixperemspace	Other
space	Other
nbspace	Other
thinspace	Other
threeperemspace	Other
zerowidthspace	Other
CR	Other
null	Other
zeroWidthNoBreakSpace	Other
cent	Figure
currency	Figure
dollar	Figure
dong	Figure
euro	Figure
florin	LowerCase
franc	Figure
lira	Figure
peseta	Figure
sheqel	Hebrew
sterling	Figure
yen	Figure
dollar.rvrn	Figure
DirectlyLeftWaveArrow	Other
acuteAngle	Other
alephsymbol	Other
allequal	Other
almostEqualToWithCircumflexAccent	Other
almostequalorequalto	Other
amalgamationOrCoproduct	Other
andWithDot	Other
angle	Other
angleWithSInside	Other
angleWithUnderbar	Other
anticlockwiseClosedCircleArrow	Other
anticlockwiseIntegration	Other
anticlockwisecontourintegral	Other
approaches	Other
approxequalorimage	Other
approximatelyEqualOrEqualTo	Other
approximatelybutnotactuallyequalto	Other
assertion	Other
asteriskmath	Other
asymptoticallyequal	Other
because	Other
betsymbol	Other
between	Other
bigReverseSolidus	Other
bigSolidus	Other
blackBowtie	Other
blackCircleWithDownArrow	Other
blackDiamondWithDownArrow	Other
blackHourglass	Other
blackLozenge	Other
bottomArcAnticlockwiseArrow	Other
bottomcurlybracket	Other
bottomparenthesis	Other
bottomtortoiseshellbracket	Other
bowtie	Other
bowtieWithLeftHalfBlack	Other
bowtieWithRightHalfBlack	Other
bulletoperator	Other
circleDividedByHorizontalBarAndTopHalfDividedByVerticalBar	Other
circleTowStrokesRight	Other
circleTwoHorizontalStrokesRight	Other
circleWithHorizontalBar	Other
circleWithSuperimposedX	Other
circulationFunction	Other
clockwiseClosedCircleArrow	Other
clockwisecontourintegral	Other
clockwiseintegral	Other
closedIntersectionWithSerifs	Other
closedSubset	Other
closedSubsetOrEqualTo	Other
closedSuperset	Other
closedSupersetOrEqualTo	Other
closedUnionWithSerifs	Other
closedUnionWithSerifsAndSmashProduct	Other
colonequals	Other
complement	Other
congruent	Other
congruentWithDotAbove	Other
containsasmemberSmall	Other
containsasnormalsubgroup	Other
containsasnormalsubgrouporequalto	Other
containslonghorizontalstroke	Other
containsoverbar	Other
containsverticalbaratendofhorizontalstroke	Other
contourintegral	Other
coproduct	Other
correspondsto	Other
cuberoot	Other
curlyand	Other
curlybracketextension	Other
curlyor	Other
daletsymbol	Other
dblintegral	Other
deltaequalto	Other
diamondoperator	Other
differencebetween	Other
divides	Other
divisionslash	Other
divisiontimes	Other
doesNotDivideWithReversedNegationSlash	Other
doesnotcontainasnormalsubgroup	Other
doesnotcontainasnormalsubgrouporequal	Other
doesnotdivide	Other
doesnotforce	Other
doesnotprecedeorequal	Other
doesnotprove	Other
doesnotsucceedorequal	Other
dotmath	Other
dotminus	Other
dotplus	Other
dottedFence	Other
doubleColonEqual	Other
doubleDownTack	Other
doubleEndedMultimap	Other
doubleLineEqualToOrGreaterThan	Other
doubleLineEqualToOrLessThan	Other
doubleLineSlantedEqualToOrGreaterThan	Other
doubleLineSlantedEqualToOrLessThan	Other
doubleLineSlantedGreaterThanOrEqualTo	Other
doubleLineSlantedLessThanOrEqualTo	Other
doubleLogicalAnd	Other
doubleLogicalOr	Other
doubleNestedGreaterThan	Other
doubleNestedLessThan	Other
doubleNestedLessThanWithUnderbar	Other
doublePlus	Other
doublePrecedes	Other
doubleSolidusOperator	Other
doubleSquareIntersection	Other
doubleSquareUnion	Other
doubleStrokeNotSign	Other
doubleSucceeds	Other
doubleUpTack	Other
doubleVerticalBarDoubleLeftTurnstile	Other
doubleVerticalBarLeftTurnstile	Other
doubleintersection	Other
doublesubset	Other
doublesuperset	Other
doubleunion	Other
doubleverticalbardoublerightturnstile	Other
downArrowToBar	Other
downArrowWithHorizontalStroke	Other
downFishTail	Other
downHarpoonWithBarbLeftBesideDownHarpoonWithBarbRight	Other
downHarpoonWithBarbLeftBesideUpHarpoonWithBarbRight	Other
downHarpoonWithBarbLeftFromBar	Other
downHarpoonWithBarbLeftToBar	Other
downHarpoonWithBarbRightFromBar	Other
downHarpoonWithBarbRightToBar	Other
downTackWithCircleBelow	Other
downThenCurvingLeftArrow	Other
downThenCurvingRightArrow	Other
downTriangleWithLeftHalfBlack	Other
downTriangleWithRightHalfBlack	Other
downTripleArrow	Other
downrightdiagonalellipsis	Other
element	Other
elementOfOpeningDown	Other
elementOfOpeningUp	Other
elementSmall	Other
elementofdotabove	Other
elementoflonghorizontalstroke	Other
elementofoverbar	Other
elementoftwohorizontalstrokes	Other
elementofunderbar	Other
elementofverticalbaratendofhorizontalstroke	Other
ellipsisvertical	Other
emptySetWithLeftArrowAbove	Other
emptySetWithOverbar	Other
emptySetWithRightArrowAbove	Other
emptysetcircleabove	Other
endofproof	Other
equalandparallelto	Other
equalsSignAboveLeftArrow	Other
equalsSignAbovePlusSign	Other
equalsSignAboveRightArrow	Other
equalsSignAboveTildeOperator	Other
equalsSignAndSlantedParallel	Other
equalsSignAndSlantedParallelWithTildeAbove	Other
equalsSignWithBumpyAbove	Other
equalsSignWithDotBelow	Other
equalsSignWithTwoDotsAboveAndTwoDotsBelow	Other
equalsWithAsterisk	Other
equalscolon	Other
equaltobydefinition	Other
equaltoorgreater-than	Other
equaltoorless-than	Other
equaltoorprecedes	Other
equaltoorsucceeds	Other
equiangularTo	Other
equivalence	Other
equivalentWithFourDotsAbove	Other
equivalentto	Other
errorBarredBlackDiamond	Other
errorBarredBlackSquare	Other
errorBarredWhiteDiamond	Other
errorBarredWhiteSquare	Other
erthan	Other
erthanorequalto	Other
estimates	Other
excess	Other
existential	Other
fallingDiagonalCrossingNorthEastArrow	Other
fallingDiagonalCrossingRisingDiagonal	Other
finitePartIntegral	Other
forces	Other
forking	Other
fourthroot	Other
fullOuterJoin	Other
geometricallyequal	Other
geometricallyequivalentto	Other
geometricproportion	Other
gimelsymbol	Other
gleichStark	Other
gradient	Other
greater-thanbutnotequalto	Other
greater-thanbutnotequivalentto	Other
greater-thandot	Other
greaterThanAboveDoubleLineEqualAboveLessThan	Other
greaterThanAboveLessThanAboveDoubleLineEqual	Other
greaterThanAboveRightArrow	Other
greaterThanAboveSimilarAboveLessThan	Other
greaterThanAboveSimilarOrEqual	Other
greaterThanAboveSlantedEqualAboveLessThanAboveSlantedEqual	Other
greaterThanAndNotApproximate	Other
greaterThanAndSingleLineNotEqualTo	Other
greaterThanBesideLessThan	Other
greaterThanClosedByCurve	Other
greaterThanClosedByCurveAboveSlantedEqual	Other
greaterThanOrApproximate	Other
greaterThanOrSlantedEqualTo	Other
greaterThanOrSlantedEqualToWithDotAbove	Other
greaterThanOrSlantedEqualToWithDotAboveLeft	Other
greaterThanOrSlantedEqualToWithDotInside	Other
greaterThanOverlappingLessThan	Other
greaterThanWithCircleInside	Other
greaterThanWithQuestionMarkAbove	Other
greaterequalorless	Other
greaterorequivalent	Other
greaterorless	Other
greateroverequal	Other
hermitianconjugatematrix	Other
homothetic	Other
horizontallineextension	Other
identicalToAndSlantedParallel	Other
identicalWithDotAbove	Other
imageof	Other
imageorapproximatelyequal	Other
incompleteInfinity	Other
increasesAs	Other
infinityNegatedWithVerticalBar	Other
integralAroundAPointOperator	Other
integralAverageWithSlash	Other
integralWithDoubleStroke	Other
integralWithIntersection	Other
integralWithLeftArrowWithHook	Other
integralWithOverbar	Other
integralWithTimesSign	Other
integralWithUnderbar	Other
integralWithUnion	Other
integralbt	Other
integralextension	Other
integraltp	Other
intercalate	Other
interiorProduct	Other
intersectionAboveBarAboveUnion	Other
intersectionAboveUnion	Other
intersectionBesideAndJoinedWithIntersection	Other
intersectionWithDot	Other
intersectionWithLogicalAnd	Other
intersectionWithOverbar	Other
invertedlazys	Other
join	Other
largeDownTack	Other
largeLeftTriangleOperator	Other
largeTripleVerticalBarOperator	Other
largeUpTack	Other
largerThan	Other
largerThanOrEqualTo	Other
leftAndRightDoubleTurnstile	Other
leftAndRightTack	Other
leftArrowAboveAlmostEqualTo	Other
leftArrowAboveReverseAlmostEqualTo	Other
leftArrowAboveReverseTildeOperator	Other
leftArrowAboveShortRightArrow	Other
leftArrowAboveTildeOperator	Other
leftArrowFromBarToBlackDiamond	Other
leftArrowTail	Other
leftArrowThroughLessThan	Other
leftArrowThroughSubset	Other
leftArrowThroughX	Other
leftArrowToBlackDiamond	Other
leftArrowWithCircledPlus	Other
leftArrowWithDottedStem	Other
leftArrowWithPlusBelow	Other
leftArrowWithTailWithDoubleVerticalStroke	Other
leftArrowWithTailWithVerticalStroke	Other
leftBarbDownRightBarbDownHarpoon	Other
leftBarbDownRightBarbUpHarpoon	Other
leftBarbUpRightBarbDownHarpoon	Other
leftBarbUpRightBarbUpHarpoon	Other
leftDoubleArrowFromBar	Other
leftDoubleArrowTail	Other
leftDoubleArrowWithVerticalStroke	Other
leftDoubleDashArrow	Other
leftFishTail	Other
leftHarpoonWithBarbDownAboveRightHarpoonWithBarbDown	Other
leftHarpoonWithBarbDownBelowLongDash	Other
leftHarpoonWithBarbDownFromBar	Other
leftHarpoonWithBarbDownToBar	Other
leftHarpoonWithBarbUpAboveLeftHarpoonWithBarbDown	Other
leftHarpoonWithBarbUpAboveLongDash	Other
leftHarpoonWithBarbUpAboveRightHarpoonWithBarbUp	Other
leftHarpoonWithBarbUpFromBar	Other
leftHarpoonWithBarbUpToBar	Other
leftMultimap	Other
leftOuterJoin	Other
leftRightDoubleArrowWithVerticalStroke	Other
leftSideArcAnticlockwiseArrow	Other
leftTriangleBesideVerticalBar	Other
leftTripleDashArrow	Other
leftTwoHeadedArrowFromBar	Other
leftTwoHeadedArrowWithDoubleVerticalStroke	Other
leftTwoHeadedArrowWithTail	Other
leftTwoHeadedArrowWithTailWithDoubleVerticalStroke	Other
leftTwoHeadedArrowWithTailWithVerticalStroke	Other
leftTwoHeadedArrowWithVerticalStroke	Other
leftTwoHeadedTripleDashArrow	Other
leftarrowwithcircle	Other
leftcurlybracketlowerhook	Other
leftcurlybracketmiddlepiece	Other
leftcurlybracketupperhook	Other
leftnormalfactorsemidirectproduct	Other
leftrightarrowthroughcircle	Other
leftsemidirectproduct	Other
leftsquarebracketextension	Other
leftsquarebracketlowercorner	Other
leftsquarebracketuppercorner	Other
less-thanbutnotequalto	Other
less-thanbutnotequivalentto	Other
less-thandot	Other
lessThanAboveDoubleLineEqualAboveGreaterThan	Other
lessThanAboveGreaterThanAboveDoubleLineEqual	Other
lessThanAboveLeftArrow	Other
lessThanAboveSimilarAboveGreaterThan	Other
lessThanAboveSimilarOrEqual	Other
lessThanAboveSlantedEqualAboveGreaterThanAboveSlantedEqual	Other
lessThanAndNotApproximate	Other
lessThanAndSingleLineNotEqualTo	Other
lessThanClosedByCurve	Other
lessThanClosedByCurveAboveSlantedEqual	Other
lessThanOrApproximate	Other
lessThanOrSlantedEqualTo	Other
lessThanOrSlantedEqualToWithDotAbove	Other
lessThanOrSlantedEqualToWithDotAboveRight	Other
lessThanOrSlantedEqualToWithDotInside	Other
lessThanWithCircleInside	Other
lessThanWithQuestionMarkAbove	Other
lessequalorgreater	Other
lessorequivalent	Other
lessorgreater	Other
lessoverequal	Other
lineIntegrationNotIncludingThePole	Other
lineIntegrationWithRectangularPathAroundPole	Other
lineIntegrationWithSemicircularPathAroundPole	Other
logicalAndWithDotAbove	Other
logicalAndWithDoubleOverbar	Other
logicalAndWithDoubleUnderbar	Other
logicalAndWithHorizontalDash	Other
logicalAndWithMiddleStem	Other
logicalAndWithUnderbar	Other
logicalOrOverlappingLogicalAnd	Other
logicalOrWithDotAbove	Other
logicalOrWithDoubleOverbar	Other
logicalOrWithDoubleUnderbar	Other
logicalOrWithHorizontalDash	Other
logicalOrWithMiddleStem	Other
logicalnotReversed	Other
longDashFromLeftMemberOfDoubleVertical	Other
longDivision	Other
longLeftSquiggleArrow	Other
longLeftTack	Other
longRightTack	Other
lowerLeftSemicircularAnticlockwiseArrow	Other
lowerRightCornerWithDot	Other
lowerRightSemicircularClockwiseArrow	Other
lozengeDividedByHorizontalRule	Other
measuredAngleOpeningLeft	Other
measuredAngleWithOpenArmEndingInArrowPointingDownAndLeft	Other
measuredAngleWithOpenArmEndingInArrowPointingDownAndRight	Other
measuredAngleWithOpenArmEndingInArrowPointingLeftAndDown	Other
measuredAngleWithOpenArmEndingInArrowPointingLeftAndUp	Other
measuredAngleWithOpenArmEndingInArrowPointingRightAndDown	Other
measuredAngleWithOpenArmEndingInArrowPointingRightAndUp	Other
measuredAngleWithOpenArmEndingInArrowPointingUpAndLeft	Other
measuredAngleWithOpenArmEndingInArrowPointingUpAndRight	Other
measuredRightAngleWithDot	Other
measuredangle	Other
measuredby	Other
midlinehorizontalellipsis	Other
minusSignInTriangle	Other
minusSignWithCommaAbove	Other
minusSignWithDotBelow	Other
minusSignWithFallingDots	Other
minusSignWithRisingDots	Other
minusplus	Other
minustilde	Other
miny	Other
models	Other
moduloTwoSum	Other
muchgreater	Other
muchless	Other
multimap	Other
multiplyInDoubleCircled	Other
multiplyInLeftHalfCircled	Other
multiplyInRightHalfCircled	Other
multiplyInTriangle	Other
multiplyWithCircumflexAccentCircled	Other
multiplyWithDotAbove	Other
multiplyWithUnderbar	Other
multiset	Other
multisetmultiplication	Other
multisetunion	Other
n-aryintersection	Other
n-arylogicaland	Other
n-arylogicalor	Other
n-aryunion	Other
nAryCircledDotOperator	Other
nAryCircledPlusOperator	Other
nAryCircledTimesOperator	Other
nArySquareIntersectionOperator	Other
nArySquareUnionOperator	Other
nAryTimesOperator	Other
nAryUnionOperatorWithDot	Other
nAryUnionOperatorWithPlus	Other
nAryWhiteVerticalBar	Other
nand	Other
negateddoubleverticalbardoublerightturnstile	Other
neitherapproximatelynoractuallyequalto	Other
neitherasubsetofnorequalto	Other
neitherasupersetofnorequalto	Other
neithergreater-thannorequivalentto	Other
neitherless-thannorequivalentto	Other
neitherless-thannorgreater-than	Other
nonforking	Other
nor	Other
normalsubgroupof	Other
normalsubgroupoforequalto	Other
northEastAndSouthWestArrow	Other
northEastArrowAndSouthEastArrow	Other
northEastArrowCrossingNorthWestArrow	Other
northEastArrowCrossingSouthEastArrow	Other
northEastArrowWithHook	Other
northWestAndSouthEastArrow	Other
northWestArrowAndNorthEastArrow	Other
northWestArrowCrossingNorthEastArrow	Other
northWestArrowWithHook	Other
notalmostequalto	Other
notasymptoticallyequalto	Other
notcontains	Other
notelement	Other
notequivalentto	Other
notgreater	Other
notgreaternorequal	Other
notgreaternorless	Other
notidentical	Other
notless	Other
notlessnorequal	Other
notnormalsubgroupof	Other
notnormalsubgroupoforequalto	Other
notparallel	Other
notprecedes	Other
notsimilar	Other
notsquareimageoforequalto	Other
notsquareoriginaloforequalto	Other
notsubset	Other
notsucceeds	Other
notsuperset	Other
nottrue	Other
obliqueAngleOpeningDown	Other
obliqueAngleOpeningUp	Other
plus	Other
minus	Other
multiply	Other
divide	Other
equal	Other
notequal	Other
greater	Other
less	Other
greaterequal	Other
lessequal	Other
plusminus	Other
approxequal	Other
asciitilde	Other
logicalnot	Other
asciicircum	Other
infinity	Other
emptyset	Other
logicaland	Other
logicalor	Other
intersection	Other
union	Other
integral	Other
Ohm	Other
increment	Other
product	Other
summation	Other
radical	Other
micro	Other
partialdiff	Other
openSubset	Other
openSuperset	Other
orWithDotInside	Other
originalof	Other
orthogonal	Other
parallel	Other
parallelWithHorizontalStroke	Other
parallelWithTildeOperator	Other
parenleftextension	Other
parenleftlowerhook	Other
parenleftupperhook	Other
parenrightextension	Other
parenrightlowerhook	Other
parenrightupperhook	Other
percent	Other
perpendicular	Other
perpendicularWithS	Other
perthousand	Other
pitchfork	Other
pitchforkWithTeeTop	Other
plusSignAboveEqualsSign	Other
plusSignInLeftHalfCircled	Other
plusSignInRightHalfCircled	Other
plusSignInTriangle	Other
plusSignWithBlackTriangle	Other
plusSignWithCircumflexAccentAbove	Other
plusSignWithDotBelow	Other
plusSignWithSubscriptTwo	Other
plusSignWithTildeAbove	Other
plusSignWithTildeBelow	Other
pluscircleabove	Other
precedes	Other
precedesAboveAlmostEqualTo	Other
precedesAboveEqualsSign	Other
precedesAboveNotAlmostEqualTo	Other
precedesAboveNotEqualTo	Other
precedesAboveSingleLineEqualsSign	Other
precedesAboveSingleLineNotEqualTo	Other
precedesbutnotequivalentto	Other
precedesorequalto	Other
precedesorequivalentto	Other
precedesunderrelation	Other
proportion	Other
proportional	Other
quadrupleIntegralOperator	Other
quaternionIntegralOperator	Other
questionedequalto	Other
ratio	Other
reflexsubset	Other
reflexsuperset	Other
reverseSolidusOperator	Other
reverseSolidusPrecedingSubset	Other
reverseSolidusWithHorizontalStroke	Other
reverseTildeOperatorAboveLeftArrow	Other
reverseTildeOperatorAboveRightArrow	Other
reversedAngle	Other
reversedAngleWithUnderbar	Other
reversedDoubleStrokeNotSign	Other
reversedEmptySet	Other
reversedtilde	Other
reversedtildeequals	Other
rightAngleVariantWithSquare	Other
rightArrowAboveAlmostEqualTo	Other
rightArrowAboveReverseAlmostEqualTo	Other
rightArrowAboveReverseTildeOperator	Other
rightArrowAboveShortLeftArrow	Other
rightArrowAboveTildeOperator	Other
rightArrowFromBarToBlackDiamond	Other
rightArrowTail	Other
rightArrowThroughGreaterThan	Other
rightArrowThroughSuperset	Other
rightArrowThroughX	Other
rightArrowToBlackDiamond	Other
rightArrowWithDottedStem	Other
rightArrowWithPlusBelow	Other
rightArrowWithTailWithDoubleVerticalStroke	Other
rightArrowWithTailWithVerticalStroke	Other
rightDoubleArrowFromBar	Other
rightDoubleArrowTail	Other
rightDoubleArrowWithRoundedHead	Other
rightDoubleArrowWithVerticalStroke	Other
rightDoubleDashArrow	Other
rightFishTail	Other
rightHarpoonWithBarbDownAboveLeftHarpoonWithBarbDown	Other
rightHarpoonWithBarbDownBelowLongDash	Other
rightHarpoonWithBarbDownFromBar	Other
rightHarpoonWithBarbDownToBar	Other
rightHarpoonWithBarbUpAboveLeftHarpoonWithBarbUp	Other
rightHarpoonWithBarbUpAboveLongDash	Other
rightHarpoonWithBarbUpAboveRightHarpoonWithBarbDown	Other
rightHarpoonWithBarbUpFromBar	Other
rightHarpoonWithBarbUpToBar	Other
rightOuterJoin	Other
rightSideArcClockwiseArrow	Other
rightThenCurvingDownArrow	Other
rightThenCurvingUpArrow	Other
rightTriangleAboveLeftTriangle	Other
rightTripleDashArrow	Other
rightTwoHeadedArrowFromBar	Other
rightTwoHeadedArrowWithDoubleVerticalStroke	Other
rightTwoHeadedArrowWithTail	Other
rightTwoHeadedArrowWithTailWithDoubleVerticalStroke	Other
rightTwoHeadedArrowWithTailWithVerticalStroke	Other
rightTwoHeadedArrowWithVerticalStroke	Other
rightTwoHeadedTripleDashArrow	Other
rightanglearc	Other
rightangledownzigzagArrow	Other
rightcurlybracketlowerhook	Other
rightcurlybracketmiddlepiece	Other
rightcurlybracketupperhook	Other
righthandInteriorProduct	Other
rightnormalfactorsemidirectproduct	Other
rightsemidirectproduct	Other
rightsquarebracketextension	Other
rightsquarebracketlowercorner	Other
rightsquarebracketuppercorner	Other
righttack	Other
righttriangle	Other
ringequalto	Other
ringinequalto	Other
ringoperator	Other
risingDiagonalCrossingFallingDiagonal	Other
risingDiagonalCrossingSouthEastArrow	Other
ruleDelayed	Other
sInTriangle	Other
semidirectProductWithBottomClosed	Other
setminus	Other
shortDownTack	Other
shortDownTackWithOverbar	Other
shortLeftTack	Other
shortRightArrowAboveLeftArrow	Other
shortUpTack	Other
shortUpTackAboveShortDownTack	Other
shortUpTackWithUnderbar	Other
shuffleProduct	Other
similar	Other
similarAboveGreaterThanAboveEqualsSign	Other
similarAboveLessThanAboveEqualsSign	Other
similarMinusSimilar	Other
similarOrGreaterThan	Other
similarOrLessThan	Other
sinewave	Other
slantedEqualToOrGreaterThan	Other
slantedEqualToOrGreaterThanWithDotInside	Other
slantedEqualToOrLessThan	Other
slantedEqualToOrLessThanWithDotInside	Other
slopingLargeAnd	Other
slopingLargeOr	Other
smallcontainsoverbar	Other
smallcontainsverticalbaratendofhorizontalstroke	Other
smallelementofoverbar	Other
smallelementofverticalbaratendofhorizontalstroke	Other
smashProduct	Other
solidusWithOverbar	Other
southEastArrowAndSouthWestArrow	Other
southEastArrowCrossingNorthEastArrow	Other
southEastArrowWithHook	Other
southWestArrowAndNorthWestArrow	Other
southWestArrowWithHook	Other
sphericalAngleOpeningLeft	Other
sphericalAngleOpeningUp	Other
sphericalangle	Other
squareLeftOpenBoxOperator	Other
squareRightOpenBoxOperator	Other
squareWithContouredOutline	Other
squarecap	Other
squarecup	Other
squaredAsterisk	Other
squaredFallingDiagonalSlash	Other
squaredLogicalAnd	Other
squaredLogicalOr	Other
squaredRisingDiagonalSlash	Other
squaredSquare	Other
squaredcircle	Other
squareddotoperator	Other
squaredminus	Other
squaredplus	Other
squaredtimes	Other
squareimageof	Other
squareimageoforequalto	Other
squareimageofornotequalto	Other
squareoriginalof	Other
squareoriginaloforequalto	Other
squareoriginalofornotequalto	Other
starequals	Other
staroperator	Other
strictlyequivalentto	Other
subset	Other
subsetAboveRightArrow	Other
subsetAboveSubset	Other
subsetAboveSuperset	Other
subsetOfAboveAlmostEqualTo	Other
subsetOfAboveEqualsSign	Other
subsetOfAboveNotEqualTo	Other
subsetOfAboveTildeOperator	Other
subsetOfOrEqualToWithDotAbove	Other
subsetWithDot	Other
subsetWithMultiplicationSignBelow	Other
subsetWithPlusSignBelow	Other
subsetnotequal	Other
succeeds	Other
succeedsAboveAlmostEqualTo	Other
succeedsAboveEqualsSign	Other
succeedsAboveNotAlmostEqualTo	Other
succeedsAboveNotEqualTo	Other
succeedsAboveSingleLineEqualsSign	Other
succeedsAboveSingleLineNotEqualTo	Other
succeedsbutnotequivalentto	Other
succeedsorequalto	Other
succeedsorequivalentto	Other
succeedsunderrelation	Other
suchthat	Other
summationWithIntegral	Other
summationbottom	Other
summationdoubleStruck	Other
summationtop	Other
superset	Other
supersetAboveLeftArrow	Other
supersetAboveSubset	Other
supersetAboveSuperset	Other
supersetBesideAndJoinedByDashWithSubset	Other
supersetBesideSubset	Other
supersetOfAboveAlmostEqualTo	Other
supersetOfAboveEqualsSign	Other
supersetOfAboveNotEqualTo	Other
supersetOfAboveTildeOperator	Other
supersetOfOrEqualToWithDotAbove	Other
supersetPrecedingSolidus	Other
supersetWithDot	Other
supersetWithMultiplicationSignBelow	Other
supersetWithPlusSignBelow	Other
supersetnotequal	Other
surfaceintegral	Other
tackdown	Other
tackleft	Other
theredoesnotexist	Other
therefore	Other
thermodynamic	Other
threeConsecutiveEqualsSigns	Other
threeDimensionalAngle	Other
threeLeftArrows	Other
tieOverInfinity	Other
tildeOperatorAboveLeftArrow	Other
tildeOperatorAboveRightArrow	Other
tildeOperatorWithDotAbove	Other
tildeOperatorWithRisingDots	Other
timesWithLeftHalfBlack	Other
timesWithRightHalfBlack	Other
tiny	Other
topArcAnticlockwiseArrow	Other
topArcAnticlockwiseArrowWithPlus	Other
topArcClockwiseArrowWithMinus	Other
topcurlybracket	Other
topparenthesis	Other
toptortoiseshellbracket	Other
transversalIntersection	Other
triangleWithDotAbove	Other
triangleWithSerifsAtBottom	Other
triangleWithUnderbar	Other
tripleColonOperator	Other
tripleHorizontalBarWithDoubleVerticalStroke	Other
tripleHorizontalBarWithTripleVerticalStroke	Other
tripleNestedGreaterThan	Other
tripleNestedLessThan	Other
triplePlus	Other
tripleSolidusBinaryRelation	Other
tripleVerticalBarBinaryRelation	Other
tripleVerticalBarDelimiter	Other
tripleVerticalBarWithHorizontalStroke	Other
tripleintegral	Other
tripletilde	Other
tripleverticalbarrightturnstile	Other
true	Other
turnedAngle	Other
twoConsecutiveEqualsSigns	Other
twoIntersectingLogicalAnd	Other
twoIntersectingLogicalOr	Other
twoJoinedSquares	Other
twoLogicalAndOperator	Other
twoLogicalOrOperator	Other
unionAboveBarAboveIntersection	Other
unionAboveIntersection	Other
unionBesideAndJoinedWithUnion	Other
unionWithLogicalOr	Other
unionWithMinusSign	Other
unionWithOverbar	Other
universal	Other
upArrowToBar	Other
upArrowWithHorizontalStroke	Other
upBarbLeftDownBarbLeftHarpoon	Other
upBarbLeftDownBarbRightHarpoon	Other
upBarbRightDownBarbLeftHarpoon	Other
upBarbRightDownBarbRightHarpoon	Other
upFishTail	Other
upHarpoonWithBarbLeftBesideDownHarpoonWithBarbRight	Other
upHarpoonWithBarbLeftBesideUpHarpoonWithBarbRight	Other
upHarpoonWithBarbLeftFromBar	Other
upHarpoonWithBarbLeftToBar	Other
upHarpoonWithBarbRightFromBar	Other
upHarpoonWithBarbRightToBar	Other
upTackWithCircleAbove	Other
upTripleArrow	Other
upperLeftCornerWithDot	Other
upperleftorlowerrightcurlybracketsection	Other
upperrightorlowerleftcurlybracketsection	Other
uprightdiagonalellipsis	Other
uptack	Other
uptwoheadedarrowfromcircle	Other
vectorOrCrossProduct	Other
veeunderbar	Other
verticalBarBesideRightTriangle	Other
verticalBarDoubleLeftTurnstile	Other
verticalBarTripleRightTurnstile	Other
verticalBarWithHorizontalStroke	Other
verticalLineWithCircleAbove	Other
verticalLineWithCircleBelow	Other
verticalZigzagLine	Other
verymuchgreater-than	Other
verymuchless-than	Other
volumeintegral	Other
waveArrowDirectlyRight	Other
whiteCircleWithDownArrow	Other
whiteConcaveSidedDiamond	Other
whiteConcaveSidedDiamondWithLeftTick	Other
whiteConcaveSidedDiamondWithRightTick	Other
whiteDiamondWithCentredDot	Other
whiteHourglass	Other
whiteSquareWithLeftTick	Other
whiteSquareWithRightTick	Other
whiteVerticalBar	Other
whitetrianglecontainingwhitetriangle	Other
wreathproduct	Other
xor	Other
zNotationDomainAntirestriction	Other
zNotationRangeAntirestriction	Other
zNotationRelationalComposition	Other
zNotationSchemaComposition	Other
zNotationSchemaPiping	Other
zNotationSchemaProjection	Other
zNotationSpot	Other
zNotationTypeColon	Other
znotationbagmembership	Other
anticlockwiseRotatedDivisionSign.circled	Other
asteriskoperator.circled	Other
bar.circled	Other
bullet.circled	Other
dash.circled	Other
divide.circled	Other
equals.circled	Other
errorBarredBlack.circled	Other
errorBarredWhite.circled	Other
fraction.circled	Other
greaterThan.circled	Other
lessThan.circled	Other
minus.circled	Other
acuteAngle.mir	Other
allequal.mir	Other
almostEqualToWithCircumflexAccent.mir	Other
almostequalorequalto.mir	Other
angle.mir	Other
angleWithSInside.mir	Other
angleWithUnderbar.mir	Other
anticlockwiseIntegration.mir	Other
anticlockwisecontourintegral.mir	Other
approximatelyEqualOrEqualTo.mir	Other
approximatelybutnotactuallyequalto.mir	Other
circleTowStrokesRight.mir	Other
circleTwoHorizontalStrokesRight.mir	Other
circulationFunction.mir	Other
clockwisecontourintegral.mir	Other
clockwiseintegral.mir	Other
complement.mir	Other
congruent.mir	Other
congruentWithDotAbove.mir	Other
contourintegral.mir	Other
cuberoot.mir	Other
dblintegral.mir	Other
doesNotDivideWithReversedNegationSlash.mir	Other
doesnotdivide.mir	Other
doesnotforce.mir	Other
doesnotprove.mir	Other
doubleColonEqual.mir	Other
doubleNestedLessThanWithUnderbar.mir	Other
doubleSolidusOperator.mir	Other
downTriangleWithLeftHalfBlack.mir	Other
downTriangleWithRightHalfBlack.mir	Other
elementofdotabove.mir	Other
elementoftwohorizontalstrokes.mir	Other
elementofunderbar.mir	Other
equalsSignAboveTildeOperator.mir	Other
equalsSignAndSlantedParallel.mir	Other
equalsSignAndSlantedParallelWithTildeAbove.mir	Other
excess.mir	Other
existential.mir	Other
finitePartIntegral.mir	Other
forking.mir	Other
fourthroot.mir	Other
greaterThanAboveSimilarAboveLessThan.mir	Other
greaterThanAboveSimilarOrEqual.mir	Other
greaterThanAndNotApproximate.mir	Other
greaterThanAndSingleLineNotEqualTo.mir	Other
greaterThanOrApproximate.mir	Other
greaterThanWithQuestionMarkAbove.mir	Other
homothetic.mir	Other
identicalToAndSlantedParallel.mir	Other
incompleteInfinity.mir	Other
increasesAs.mir	Other
integralAroundAPointOperator.mir	Other
integralAverageWithSlash.mir	Other
integralWithDoubleStroke.mir	Other
integralWithIntersection.mir	Other
integralWithLeftArrowWithHook.mir	Other
integralWithOverbar.mir	Other
integralWithTimesSign.mir	Other
integralWithUnderbar.mir	Other
integralWithUnion.mir	Other
integralbt.mir	Other
integraltp.mir	Other
invertedlazys.mir	Other
largeLeftTriangleOperator.mir	Other
leftMultimap.mir	Other
lessThanAboveSimilarAboveGreaterThan.mir	Other
lessThanAboveSimilarOrEqual.mir	Other
lessThanAndNotApproximate.mir	Other
lessThanAndSingleLineNotEqualTo.mir	Other
lessThanOrApproximate.mir	Other
lessThanWithQuestionMarkAbove.mir	Other
lineIntegrationNotIncludingThePole.mir	Other
lineIntegrationWithRectangularPathAroundPole.mir	Other
lineIntegrationWithSemicircularPathAroundPole.mir	Other
longDashFromLeftMemberOfDoubleVertical.mir	Other
longDivision.mir	Other
lowerRightCornerWithDot.mir	Other
measuredAngleOpeningLeft.mir	Other
measuredAngleWithOpenArmEndingInArrowPointingDownAndLeft.mir	Other
measuredAngleWithOpenArmEndingInArrowPointingDownAndRight.mir	Other
measuredAngleWithOpenArmEndingInArrowPointingLeftAndDown.mir	Other
measuredAngleWithOpenArmEndingInArrowPointingLeftAndUp.mir	Other
measuredAngleWithOpenArmEndingInArrowPointingRightAndDown.mir	Other
measuredAngleWithOpenArmEndingInArrowPointingRightAndUp.mir	Other
measuredAngleWithOpenArmEndingInArrowPointingUpAndLeft.mir	Other
measuredAngleWithOpenArmEndingInArrowPointingUpAndRight.mir	Other
measuredRightAngleWithDot.mir	Other
measuredangle.mir	Other
minusSignWithCommaAbove.mir	Other
minustilde.mir	Other
models.mir	Other
moduloTwoSum.mir	Other
multimap.mir	Other
multiset.mir	Other
negateddoubleverticalbardoublerightturnstile.mir	Other
neitherapproximatelynoractuallyequalto.mir	Other
notalmostequalto.mir	Other
notasymptoticallyequalto.mir	Other
notidentical.mir	Other
notparallel.mir	Other
notsimilar.mir	Other
nottrue.mir	Other
obliqueAngleOpeningDown.mir	Other
obliqueAngleOpeningUp.mir	Other
notequal.mir	Other
approxequal.mir	Other
integral.mir	Other
summation.mir	Other
radical.mir	Other
partialdiff.mir	Other
orthogonal.mir	Other
parallelWithTildeOperator.mir	Other
plusSignWithTildeAbove.mir	Other
plusSignWithTildeBelow.mir	Other
precedesAboveAlmostEqualTo.mir	Other
precedesAboveNotAlmostEqualTo.mir	Other
precedesAboveNotEqualTo.mir	Other
precedesAboveSingleLineNotEqualTo.mir	Other
proportional.mir	Other
quadrupleIntegralOperator.mir	Other
quaternionIntegralOperator.mir	Other
questionedequalto.mir	Other
reverseSolidusWithHorizontalStroke.mir	Other
reversedAngle.mir	Other
reversedAngleWithUnderbar.mir	Other
rightAngleVariantWithSquare.mir	Other
rightTriangleAboveLeftTriangle.mir	Other
rightanglearc.mir	Other
righttriangle.mir	Other
ruleDelayed.mir	Other
setminus.mir	Other
similarAboveGreaterThanAboveEqualsSign.mir	Other
similarAboveLessThanAboveEqualsSign.mir	Other
similarMinusSimilar.mir	Other
similarOrGreaterThan.mir	Other
similarOrLessThan.mir	Other
sinewave.mir	Other
slopingLargeAnd.mir	Other
slopingLargeOr.mir	Other
solidusWithOverbar.mir	Other
sphericalAngleOpeningLeft.mir	Other
sphericalangle.mir	Other
subsetOfAboveAlmostEqualTo.mir	Other
subsetOfAboveNotEqualTo.mir	Other
subsetOfAboveTildeOperator.mir	Other
succeedsAboveAlmostEqualTo.mir	Other
succeedsAboveNotAlmostEqualTo.mir	Other
succeedsAboveNotEqualTo.mir	Other
succeedsAboveSingleLineNotEqualTo.mir	Other
summationWithIntegral.mir	Other
summationdoubleStruck.mir	Other
supersetOfAboveAlmostEqualTo.mir	Other
supersetOfAboveNotEqualTo.mir	Other
supersetOfAboveTildeOperator.mir	Other
surfaceintegral.mir	Other
theredoesnotexist.mir	Other
threeDimensionalAngle.mir	Other
tildeOperatorWithDotAbove.mir	Other
tildeOperatorWithRisingDots.mir	Other
tripleSolidusBinaryRelation.mir	Other
tripleintegral.mir	Other
tripletilde.mir	Other
tripleverticalbarrightturnstile.mir	Other
turnedAngle.mir	Other
twoJoinedSquares.mir	Other
upperLeftCornerWithDot.mir	Other
verticalBarTripleRightTurnstile.mir	Other
volumeintegral.mir	Other
wreathproduct.mir	Other
zNotationRelationalComposition.mir	Other
zNotationSchemaComposition.mir	Other
zNotationSchemaPiping.mir	Other
zNotationSchemaProjection.mir	Other
znotationbagmembership.mir	Other
multiply.circled	Other
operator.circled	Other
parallel.circled	Other
perpendicular.circled	Other
plus.circled	Other
reverseSolidus.circled	Other
ringoperator.circled	Other
upArrowThrough.circled	Other
whiteBullet.circled	Other
upArrow	Other
northEastArrow	Other
rightArrow	Other
southEastArrow	Other
downArrow	Other
southWestArrow	Other
leftArrow	Other
northWestArrow	Other
leftRightArrow	Other
upDownArrow	Other
downAndUpArrow	Other
leftStrokeArrow	Other
rightStrokeArrow	Other
leftVerticalStrokeArrow	Other
rightVerticalStrokeArrow	Other
leftRightVerticalStrokeArrow	Other
leftDoubleVerticalStrokeArrow	Other
rightDoubleVerticalStrokeArrow	Other
leftRightStrokeArrow	Other
leftRightDoubleVerticalStrokeArrow	Other
leftWaveArrow	Other
rightWaveArrow	Other
leftRightWaveArrow	Other
leftTwoheadedArrow	Other
upTwoHeadedArrow	Other
rightTwoheadedArrow	Other
downTwoheadedArrow	Other
leftTailArrow	Other
rightTailArrow	Other
leftFrombarArrow	Other
upFrombarArrow	Other
rightFrombarArrow	Other
downFrombarArrow	Other
upDownbaseArrow	Other
leftTabArrow	Other
rightTabArrow	Other
leftToBarOverRightToBarArrow	Other
leftHookArrow	Other
rightHookArrow	Other
leftLoopArrow	Other
rightLoopArrow	Other
upTipLeftArrow	Other
upTipRightArrow	Other
downTipLeftArrow	Other
downTipRightArrow	Other
rightCornerDownArrow	Other
carriagereturn	Other
rightTipDownArrow	Other
rightTipUpArrow	Other
leftArrowTipDown	Other
leftArrowTipUp	Other
topCircleLeftArrow	Other
topCircleRightArrow	Other
northWestToLongbarArrow	Other
northWestArrowToCorner	Other
southEastArrowToCorner	Other
anticlockwiseOpenCircleArrow	Other
anticlockwiseGappedCircleArrow	Other
clockwiseOpenCircleArrow	Other
clockwiseGappedCircleArrow	Other
leftBarbUpHarpoon	Other
leftBarbDownHarpoon	Other
upBarbRightharpoon	Other
upBarbLeftharpoon	Other
rightBarbUpHarpoon	Other
rightBarbdownHarpoon	Other
downBarbRightHarpoon	Other
downBarbLeftHarpoon	Other
leftOverRightHarpoon	Other
rightOverLeftHarpoon	Other
rightOverLeftArrow	Other
upAndDownArrow	Other
leftAndRightArrow	Other
upDoublePairedArrow	Other
rightDoublePairedArrow	Other
downDoublePairedArrow	Other
leftDoublePairedArrow	Other
upDoubleArrow	Other
northEastDoubleArrow	Other
rightDoubleArrow	Other
southEastDoubleArrow	Other
downDoubleArrow	Other
southWestDoubleArrow	Other
leftDoubleArrow	Other
northWestDoubleArrow	Other
leftRightDoubleArrow	Other
upDownDoubleArrow	Other
leftDoubleStrokeArrow	Other
leftRightDoubleStrokeArrow	Other
rightDoubleStrokeArrow	Other
leftTripleArrow	Other
rightTripleArrow	Other
leftSquiggleArrow	Other
rightSquiggleArrow	Other
leftDashArrow	Other
upDashArrow	Other
rightDashArrow	Other
dashdownArrow	Other
rightCircleArrow	Other
threeRightArrow	Other
leftOpenHeadedArrow	Other
rightOpenHeadedArrow	Other
leftRightOpenHeadedArrow	Other
upQuadrupleArrow	Other
downQuadrupleArrow	Other
rightCircledPlusArrow	Other
leftLongArrow	Other
rightlongArrow	Other
leftRightLongArrow	Other
leftLongDoubleArrow	Other
rightLongDoubleArrow	Other
leftRightLongDoubleArrow	Other
leftLongFromBarArrow	Other
rightLongFromBarArrow	Other
leftLongDoubleFromBarArrow	Other
rightLongDoubleFromBarArrow	Other
rightLongSquiggleArrow	Other
dottedCircle	Other
lozenge	Other
whiteVerticalRect	Other
mediumWhiteSquare	Other
upWhiteTriangle	Other
rightWhiteTriangle	Other
downWhiteTriangle	Other
leftWhiteTriangle	Other
APLIbeam	Other
APLalpha	Other
APLalphaunderbar	Other
APLbackslashbar	Other
APLcirclebackslash	Other
APLcircledieresis	Other
APLcirclejot	Other
APLcirclestar	Other
APLcirclestile	Other
APLcircleunderbar	Other
APLcommabar	Other
APLdeldieresis	Other
APLdelstile	Other
APLdeltastile	Other
APLdeltaunderbar	Other
APLdeltilde	Other
APLdiamondunderbar	Other
APLdowncarettilde	Other
APLdownshoestile	Other
APLdowntackjot	Other
APLdowntackunderbar	Other
APLdownvane	Other
APLepsilonunderbar	Other
APLgreaterthandieresis	Other
APLiota	Other
APLiotaunderbar	Other
APLjotdieresis	Other
APLjotunderbar	Other
APLleftshoestile	Other
APLleftvane	Other
APLomega	Other
APLomegaunderbar	Other
APLquad	Other
APLquadbackslash	Other
APLquadcircle	Other
APLquadcolon	Other
APLquaddel	Other
APLquaddelta	Other
APLquaddiamond	Other
APLquaddivide	Other
APLquaddownarrow	Other
APLquaddowncaret	Other
APLquadequal	Other
APLquadgreater-than	Other
APLquadjot	Other
APLquadleftarrow	Other
APLquadless-than	Other
APLquadnotequal	Other
APLquadquestion	Other
APLquadrightarrow	Other
APLquadslash	Other
APLquaduparrow	Other
APLquadupcaret	Other
APLquotequad	Other
APLquoteunderbar	Other
APLrho	Other
APLrightvane	Other
APLsemicolonunderbar	Other
APLslashbar	Other
APLsquishquad	Other
APLstardieresis	Other
APLstiletilde	Other
APLtildedieresis	Other
APLupcarettilde	Other
APLupshoejot	Other
APLuptackdieresis	Other
APLuptackjot	Other
APLuptackoverbar	Other
APLupvane	Other
APLzilde	Other
rightQuadrupleArrow	Other
leftQuadrupleArrow	Other
at	Other
ampersand	Other
paragraph	Other
section	Other
copyright	Other
registered	Other
trademark	Other
careof	Other
degree	Other
minute	Other
second	Other
bar	Other
brokenbar	Other
dagger	Other
literSign	Other
daggerdbl	Other
numero	Other
estimated	Other
bottomsquarebracket	Other
bottomsquarebracketovertopsquarebracket	Other
bottomLeftCorner	Other
bottomRightCorner	Other
topRightcorner	Other
topLeftCorner	Other
pagedown	Other
pageup	Other
objectReplacementCharacter	Other
replacementCharacter	Other
servicemark	Other
topsquarebracket	Other
turnedNotSign	Other
verticallineextension	Other
lowringmod	Other
flat-musical	Other
natural-musical	Other
sharp-musical	Other
fallingDiagonal-math	Other
risingDiagonal-math	Other
fallingDiagonal-math.mir	Other
risingDiagonal-math.mir	Other
thousand-cy	Other
apostrophemod	Other
firsttonechinese	Other
AnnuitySymbol	Other
dieresiscomb	Other
dotaccentcomb	Other
gravecomb	Other
acutecomb	Other
hungarumlautcomb	Other
circumflexcomb	Other
caroncomb	Other
brevecomb	Other
ringcomb	Other
tildecomb	Other
macroncomb	Other
overlinecomb	Other
hookabovecomb	Other
dblgravecomb	Other
commaturnedabovecomb	Other
dotbelowcomb	Other
commaaccentcomb	Other
cedillacomb	Other
ogonekcomb	Other
tildebelowcomb	Other
acute	Other
anticlockwisearrowabovecomb	Other
anticlockwiseringoverlaycomb	Other
breve	Other
caron	Other
cedilla	Other
circumflex	Other
clockwisearrowabovecomb	Other
clockwiseringoverlaycomb	Other
dieresis	Other
dotaccent	Other
doubleverticalstrokeoverlaycomb	Other
fourdotsabovecomb	Other
grave	Other
hungarumlaut	Other
leftarrowabovecomb	Other
leftarrowbelowcomb	Other
leftarrowoverlaycomb	Other
leftharpoonabovecomb	Other
leftharpoonwithbarbdowncomb	Other
leftrightarrowabovecomb	Other
longdoublesolidusoverlaycomb	Other
longverticallineoverlaycomb	Other
macron	Other
ogonek	Other
reversesolidusoverlaycomb	Other
rightarrowabovecomb	Other
rightarrowbelowcomb	Other
rightharpoonabovecomb	Other
rightharpoonwithbarbdowncomb	Other
ring	Other
ringoverlaycomb	Other
shortverticallineoverlaycomb	Other
threedotsabovecomb	Other
tilde	Other
tripleunderdotcomb	Other
widebridgeabovecomb	Other
caron.alt	Other
shindot-hb	Other
sheva-hb	Other
hatafsegol-hb	Other
hatafpatah-hb	Other
hatafqamats-hb	Other
hiriq-hb	Other
tsere-hb	Other
segol-hb	Other
patah-hb	Other
qamats-hb	Other
holam-hb	Other
holamhaser-hb	Other
qubuts-hb	Other
dagesh-hb	Other
siluqleft-hb	Other
sindot-hb	Other
qamatsqatan-hb	Other
dagesh-hb.small	Other
tonos	Other
dieresistonos	Other
dasiaoxia	Other
titlocomb-cy	Other
palatalizationcomb-cy	Other
dasiapneumatacomb-cy	Other
psilipneumatacomb-cy	Other
hundredthousandssigncomb-cy	Other
millionssigncomb-cy	Other
brevecomb-cy	Other
uni047A	UpperCase
uni047B	UpperCase
uni047C	UpperCase
uni047D	UpperCase
uni047E	UpperCase
uni047F	UpperCase
u1D5A0	UpperCase
u1D5A1	UpperCase
u1D5A2	UpperCase
u1D5A3	UpperCase
u1D5A4	UpperCase
u1D5A5	UpperCase
u1D5A6	UpperCase
u1D5A7	UpperCase
u1D5A8	UpperCase
u1D5A9	UpperCase
u1D5AA	UpperCase
u1D5AB	UpperCase
u1D5AC	UpperCase
u1D5AD	UpperCase
u1D5AE	UpperCase
u1D5AF	UpperCase
u1D5B0	UpperCase
u1D5B1	UpperCase
u1D5B2	UpperCase
u1D5B3	UpperCase
u1D5B4	UpperCase
u1D5B5	UpperCase
u1D5B6	UpperCase
u1D5B7	UpperCase
u1D5B8	UpperCase
u1D5B9	UpperCase
u1D5BA	LowerCase
u1D5BB	LowerCase
u1D5BC	LowerCase
u1D5BD	LowerCase
u1D5BE	LowerCase
u1D5BF	LowerCase
u1D5C0	LowerCase
u1D5C1	LowerCase
u1D5C2	LowerCase
u1D5C3	LowerCase
u1D5C4	LowerCase
u1D5C5	LowerCase
u1D5C6	LowerCase
u1D5C7	LowerCase
u1D5C8	LowerCase
u1D5C9	LowerCase
u1D5CA	LowerCase
u1D5CB	LowerCase
u1D5CC	LowerCase
u1D5CD	LowerCase
u1D5CE	LowerCase
u1D5CF	LowerCase
u1D5D0	LowerCase
u1D5D1	LowerCase
u1D5D2	LowerCase
u1D5D3	LowerCase
u1D5D4	UpperCase
u1D5D5	UpperCase
u1D5D6	UpperCase
u1D5D7	UpperCase
u1D5D8	UpperCase
u1D5D9	UpperCase
u1D5DA	UpperCase
u1D5DB	UpperCase
u1D5DC	UpperCase
u1D5DD	UpperCase
u1D5DE	UpperCase
u1D5DF	UpperCase
u1D5E0	UpperCase
u1D5E1	UpperCase
u1D5E2	UpperCase
u1D5E3	UpperCase
u1D5E4	UpperCase
u1D5E5	UpperCase
u1D5E6	UpperCase
u1D5E7	UpperCase
u1D5E8	UpperCase
u1D5E9	UpperCase
u1D5EA	UpperCase
u1D5EB	UpperCase
u1D5EC	UpperCase
u1D5ED	UpperCase
u1D5EE	LowerCase
u1D5EF	LowerCase
u1D5F0	LowerCase
u1D5F1	LowerCase
u1D5F2	LowerCase
u1D5F3	LowerCase
u1D5F4	LowerCase
u1D5F5	LowerCase
u1D5F6	LowerCase
u1D5F7	LowerCase
u1D5F8	LowerCase
u1D5F9	LowerCase
u1D5FA	LowerCase
u1D5FB	LowerCase
u1D5FC	LowerCase
u1D5FD	LowerCase
u1D5FE	LowerCase
u1D5FF	LowerCase
u1D600	LowerCase
u1D601	LowerCase
u1D602	LowerCase
u1D603	LowerCase
u1D604	LowerCase
u1D605	LowerCase
u1D606	LowerCase
u1D607	LowerCase
u1D608	UpperCase
u1D609	UpperCase
u1D60A	UpperCase
u1D60B	UpperCase
u1D60C	UpperCase
u1D60D	UpperCase
u1D60E	UpperCase
u1D60F	UpperCase
u1D610	UpperCase
u1D611	UpperCase
u1D612	UpperCase
u1D613	UpperCase
u1D614	UpperCase
u1D615	UpperCase
u1D616	UpperCase
u1D617	UpperCase
u1D618	UpperCase
u1D619	UpperCase
u1D61A	UpperCase
u1D61B	UpperCase
u1D61C	UpperCase
u1D61D	UpperCase
u1D61E	UpperCase
u1D61F	UpperCase
u1D620	UpperCase
u1D621	UpperCase
u1D622	LowerCase
u1D623	LowerCase
u1D624	LowerCase
u1D625	LowerCase
u1D626	LowerCase
u1D627	LowerCase
u1D628	LowerCase
u1D629	LowerCase
u1D62A	LowerCase
u1D62B	LowerCase
u1D62C	LowerCase
u1D62D	LowerCase
u1D62E	LowerCase
u1D62F	LowerCase
u1D630	LowerCase
u1D631	LowerCase
u1D632	LowerCase
u1D633	LowerCase
u1D634	LowerCase
u1D635	LowerCase
u1D636	LowerCase
u1D637	LowerCase
u1D638	LowerCase
u1D639	LowerCase
u1D63A	LowerCase
u1D63B	LowerCase
u1D63C	UpperCase
u1D63D	UpperCase
u1D63E	UpperCase
u1D63F	UpperCase
u1D640	UpperCase
u1D641	UpperCase
u1D642	UpperCase
u1D643	UpperCase
u1D644	UpperCase
u1D645	UpperCase
u1D646	UpperCase
u1D647	UpperCase
u1D648	UpperCase
u1D649	UpperCase
u1D64A	UpperCase
u1D64B	UpperCase
u1D64C	UpperCase
u1D64D	UpperCase
u1D64E	UpperCase
u1D64F	UpperCase
u1D650	UpperCase
u1D651	UpperCase
u1D652	UpperCase
u1D653	UpperCase
u1D654	UpperCase
u1D655	UpperCase
u1D656	LowerCase
u1D657	LowerCase
u1D658	LowerCase
u1D659	LowerCase
u1D65A	LowerCase
u1D65B	LowerCase
u1D65C	LowerCase
u1D65D	LowerCase
u1D65E	LowerCase
u1D65F	LowerCase
u1D660	LowerCase
u1D661	LowerCase
u1D662	LowerCase
u1D663	LowerCase
u1D664	LowerCase
u1D665	LowerCase
u1D666	LowerCase
u1D667	LowerCase
u1D668	LowerCase
u1D669	LowerCase
u1D66A	LowerCase
u1D66B	LowerCase
u1D66C	LowerCase
u1D66D	LowerCase
u1D66E	LowerCase
u1D66F	LowerCase
u1D670	Other
u1D671	Other
u1D672	Other
u1D673	Other
u1D674	Other
u1D675	Other
u1D676	Other
u1D677	Other
u1D678	Other
u1D679	Other
u1D67A	Other
u1D67B	Other
u1D67C	Other
u1D67D	Other
u1D67E	Other
u1D67F	Other
u1D680	Other
u1D681	Other
u1D682	Other
u1D683	Other
u1D684	Other
u1D685	Other
u1D686	Other
u1D687	Other
u1D688	Other
u1D689	Other
u1D68A	Other
u1D68B	Other
u1D68C	Other
u1D68D	Other
u1D68E	Other
u1D68F	Other
u1D690	Other
u1D691	Other
u1D692	Other
u1D693	Other
u1D694	Other
u1D695	Other
u1D696	Other
u1D697	Other
u1D698	Other
u1D699	Other
u1D69A	Other
u1D69B	Other
u1D69C	Other
u1D69D	Other
u1D69E	Other
u1D69F	Other
u1D6A0	Other
u1D6A1	Other
u1D6A2	Other
u1D6A3	Other
u1D6A4	Other
u1D6A5	Other
u1D6A8	Other
u1D6A9	Other
u1D6AA	Other
u1D6AB	Other
u1D6AC	Other
u1D6AD	Other
u1D6AE	Other
u1D6AF	Other
u1D6B0	Other
u1D6B1	Other
u1D6B2	Other
u1D6B3	Other
u1D6B4	Other
u1D6B5	Other
u1D6B6	Other
u1D6B7	Other
u1D6B8	Other
u1D6B9	Other
u1D6BA	Other
u1D6BB	Other
u1D6BC	Other
u1D6BD	Other
u1D6BE	Other
u1D6BF	Other
u1D6C0	Other
u1D6C1	Other
u1D6C2	Other
u1D6C3	Other
u1D6C4	Other
u1D6C5	Other
u1D6C6	Other
u1D6C7	Other
u1D6C8	Other
u1D6C9	Other
u1D6CA	Other
u1D6CB	Other
u1D6CC	Other
u1D6CD	Other
u1D6CE	Other
u1D6CF	Other
u1D6D0	Other
u1D6D1	Other
u1D6D2	Other
u1D6D3	Other
u1D6D4	Other
u1D6D5	Other
u1D6D6	Other
u1D6D7	Other
u1D6D8	Other
u1D6D9	Other
u1D6DA	Other
u1D6DB	Other
u1D6DC	Other
u1D6DD	Other
u1D6DE	Other
u1D6DF	Other
u1D6E0	Other
u1D6E1	Other
u1D6E2	Other
u1D6E3	Other
u1D6E4	Other
u1D6E5	Other
u1D6E6	Other
u1D6E7	Other
u1D6E8	Other
u1D6E9	Other
u1D6EA	Other
u1D6EB	Other
u1D6EC	Other
u1D6ED	Other
u1D6EE	Other
u1D6EF	Other
u1D6F0	Other
u1D6F1	Other
u1D6F2	Other
u1D6F3	Other
u1D6F4	Other
u1D6F5	Other
u1D6F6	Other
u1D6F7	Other
u1D6F8	Other
u1D6F9	Other
u1D6FA	Other
u1D6FB	Other
u1D6FC	Other
u1D6FD	Other
u1D6FE	Other
u1D6FF	Other
u1D700	Other
u1D701	Other
u1D702	Other
u1D703	Other
u1D704	Other
u1D705	Other
u1D706	Other
u1D707	Other
u1D708	Other
u1D709	Other
u1D70A	Other
u1D70B	Other
u1D70C	Other
u1D70D	Other
u1D70E	Other
u1D70F	Other
u1D710	Other
u1D711	Other
u1D712	Other
u1D713	Other
u1D714	Other
u1D715	Other
u1D716	Other
u1D717	Other
u1D718	Other
u1D719	Other
u1D71A	Other
u1D71B	Other
u1D71C	Other
u1D71D	Other
u1D71E	Other
u1D71F	Other
u1D720	Other
u1D721	Other
u1D722	Other
u1D723	Other
u1D724	Other
u1D725	Other
u1D726	Other
u1D727	Other
u1D728	Other
u1D729	Other
u1D72A	Other
u1D72B	Other
u1D72C	Other
u1D72D	Other
u1D72E	Other
u1D72F	Other
u1D730	Other
u1D731	Other
u1D732	Other
u1D733	Other
u1D734	Other
u1D735	Other
u1D736	Other
u1D737	Other
u1D738	Other
u1D739	Other
u1D73A	Other
u1D73B	Other
u1D73C	Other
u1D73D	Other
u1D73E	Other
u1D73F	Other
u1D740	Other
u1D741	Other
u1D742	Other
u1D743	Other
u1D744	Other
u1D745	Other
u1D746	Other
u1D747	Other
u1D748	Other
u1D749	Other
u1D74A	Other
u1D74B	Other
u1D74C	Other
u1D74D	Other
u1D74E	Other
u1D74F	Other
u1D750	Other
u1D751	Other
u1D752	Other
u1D753	Other
u1D754	Other
u1D755	Other
u1D756	UpperCase
u1D757	UpperCase
u1D758	UpperCase
u1D759	UpperCase
u1D75A	UpperCase
u1D75B	UpperCase
u1D75C	UpperCase
u1D75D	UpperCase
u1D75E	UpperCase
u1D75F	UpperCase
u1D760	UpperCase
u1D761	UpperCase
u1D762	UpperCase
u1D763	UpperCase
u1D764	UpperCase
u1D765	UpperCase
u1D766	UpperCase
u1D767	UpperCase
u1D768	UpperCase
u1D769	UpperCase
u1D76A	UpperCase
u1D76B	UpperCase
u1D76C	UpperCase
u1D76D	UpperCase
u1D76E	UpperCase
u1D76F	UpperCase
u1D770	LowerCase
u1D771	LowerCase
u1D772	LowerCase
u1D773	LowerCase
u1D774	LowerCase
u1D775	LowerCase
u1D776	LowerCase
u1D777	LowerCase
u1D778	LowerCase
u1D779	LowerCase
u1D77A	LowerCase
u1D77B	LowerCase
u1D77C	LowerCase
u1D77D	LowerCase
u1D77E	LowerCase
u1D77F	LowerCase
u1D780	LowerCase
u1D781	LowerCase
u1D782	LowerCase
u1D783	LowerCase
u1D784	LowerCase
u1D785	LowerCase
u1D786	LowerCase
u1D787	LowerCase
u1D788	LowerCase
u1D789	LowerCase
u1D78A	LowerCase
u1D78B	LowerCase
u1D78C	LowerCase
u1D78D	LowerCase
u1D78E	LowerCase
u1D78F	LowerCase
u1D790	UpperCase
u1D791	UpperCase
u1D792	UpperCase
u1D793	UpperCase
u1D794	UpperCase
u1D795	UpperCase
u1D796	UpperCase
u1D797	UpperCase
u1D798	UpperCase
u1D799	UpperCase
u1D79A	UpperCase
u1D79B	UpperCase
u1D79C	UpperCase
u1D79D	UpperCase
u1D79E	UpperCase
u1D79F	UpperCase
u1D7A0	UpperCase
u1D7A1	UpperCase
u1D7A2	UpperCase
u1D7A3	UpperCase
u1D7A4	UpperCase
u1D7A5	UpperCase
u1D7A6	UpperCase
u1D7A7	UpperCase
u1D7A8	UpperCase
u1D7A9	UpperCase
u1D7AA	LowerCase
u1D7AB	LowerCase
u1D7AC	LowerCase
u1D7AD	LowerCase
u1D7AE	LowerCase
u1D7AF	LowerCase
u1D7B0	LowerCase
u1D7B1	LowerCase
u1D7B2	LowerCase
u1D7B3	LowerCase
u1D7B4	LowerCase
u1D7B5	LowerCase
u1D7B6	LowerCase
u1D7B7	LowerCase
u1D7B8	LowerCase
u1D7B9	LowerCase
u1D7BA	LowerCase
u1D7BB	LowerCase
u1D7BC	LowerCase
u1D7BD	LowerCase
u1D7BE	LowerCase
u1D7BF	LowerCase
u1D7C0	LowerCase
u1D7C1	LowerCase
u1D7C2	LowerCase
u1D7C3	LowerCase
u1D7C4	LowerCase
u1D7C5	LowerCase
u1D7C6	LowerCase
u1D7C7	LowerCase
u1D7C8	LowerCase
u1D7C9	LowerCase
u1D7CA	Other
u1D7CB	Other
u1D7CE	Other
u1D7CF	Other
u1D7D0	Other
u1D7D1	Other
u1D7D2	Other
u1D7D3	Other
u1D7D4	Other
u1D7D5	Other
u1D7D6	Other
u1D7D7	Other
u1D7D8	Other
u1D7D9	Other
u1D7DA	Other
u1D7DB	Other
u1D7DC	Other
u1D7DD	Other
u1D7DE	Other
u1D7DF	Other
u1D7E0	Other
u1D7E1	Other
u1D7E2	Other
u1D7E3	Other
u1D7E4	Other
u1D7E5	Other
u1D7E6	Other
u1D7E7	Other
u1D7E8	Other
u1D7E9	Other
u1D7EA	Other
u1D7EB	Other
u1D7EC	Other
u1D7ED	Other
u1D7EE	Other
u1D7EF	Other
u1D7F0	Other
u1D7F1	Other
u1D7F2	Other
u1D7F3	Other
u1D7F4	Other
u1D7F5	Other
u1D7F6	Other
u1D7F7	Other
u1D7F8	Other
u1D7F9	Other
u1D7FA	Other
u1D7FB	Other
u1D7FC	Other
u1D7FD	Other
u1D7FE	Other
u1D7FF	Other
alefArabic-math	Other
behArabic-math	Other
jeemArabic-math	Other
dalArabic-math	Other
wawArabic-math	Other
zainArabic-math	Other
hahArabic-math	Other
tahArabic-math	Other
yehArabic-math	Other
kafArabic-math	Other
lamArabic-math	Other
meemArabic-math	Other
noonArabic-math	Other
seenArabic-math	Other
ainArabic-math	Other
fehArabic-math	Other
sadArabic-math	Other
qafArabic-math	Other
rehArabic-math	Other
sheenArabic-math	Other
tehArabic-math	Other
thehArabic-math	Other
khahArabic-math	Other
thalArabic-math	Other
dadArabic-math	Other
zahArabic-math	Other
ghainArabic-math	Other
behDotlessArabic-math	Other
noonDotlessArabic-math	Other
fehDotlessArabic-math	Other
qafDotlessArabic-math	Other
initialbehArabic-math	Other
initialjeemArabic-math	Other
initialhehArabic-math	Other
initialhahArabic-math	Other
initialyehArabic-math	Other
initialkafArabic-math	Other
initiallamArabic-math	Other
initialmeemArabic-math	Other
initialnoonArabic-math	Other
initialseenArabic-math	Other
initialainArabic-math	Other
initialfehArabic-math	Other
initialsadArabic-math	Other
initialqafArabic-math	Other
initialsheenArabic-math	Other
initialtehArabic-math	Other
initialthehArabic-math	Other
initialkhahArabic-math	Other
initialdadArabic-math	Other
initialghainArabic-math	Other
tailedjeemArabic-math	Other
tailedhahArabic-math	Other
tailedyehArabic-math	Other
tailedlamArabic-math	Other
tailednoonArabic-math	Other
tailedseenArabic-math	Other
tailedainArabic-math	Other
tailedsadArabic-math	Other
tailedqafArabic-math	Other
tailedsheenArabic-math	Other
tailedkhahArabic-math	Other
taileddadArabic-math	Other
tailedghainArabic-math	Other
taileddotlessnoonArabic-math	Other
taileddotlessqafArabic-math	Other
stretchedbehArabic-math	Other
stretchedjeemArabic-math	Other
stretchedhehArabic-math	Other
stretchedhahArabic-math	Other
stretchedtahArabic-math	Other
stretchedyehArabic-math	Other
stretchedkafArabic-math	Other
stretchedmeemArabic-math	Other
stretchednoonArabic-math	Other
stretchedseenArabic-math	Other
stretchedainArabic-math	Other
stretchedfehArabic-math	Other
stretchedsadArabic-math	Other
stretchedqafArabic-math	Other
stretchedsheenArabic-math	Other
stretchedtehArabic-math	Other
stretchedthehArabic-math	Other
stretchedkhahArabic-math	Other
stretcheddadArabic-math	Other
stretchedzahArabic-math	Other
stretchedghainArabic-math	Other
stretcheddotlessbehArabic-math	Other
stretcheddotlessfehArabic-math	Other
loopedalefArabic-math	Other
loopedbehArabic-math	Other
loopedjeemArabic-math	Other
loopeddalArabic-math	Other
loopedhehArabic-math	Other
loopedwawArabic-math	Other
loopedzainArabic-math	Other
loopedhahArabic-math	Other
loopedtahArabic-math	Other
loopedyehArabic-math	Other
loopedlamArabic-math	Other
loopedmeemArabic-math	Other
loopednoonArabic-math	Other
loopedseenArabic-math	Other
loopedainArabic-math	Other
loopedfehArabic-math	Other
loopedsadArabic-math	Other
loopedqafArabic-math	Other
loopedrehArabic-math	Other
loopedsheenArabic-math	Other
loopedtehArabic-math	Other
loopedthehArabic-math	Other
loopedkhahArabic-math	Other
loopedthalArabic-math	Other
loopeddadArabic-math	Other
loopedzahArabic-math	Other
loopedghainArabic-math	Other
doublestruckbehArabic-math	Other
doublestruckjeemArabic-math	Other
doublestruckdalArabic-math	Other
doublestruckwawArabic-math	Other
doublestruckzainArabic-math	Other
doublestruckhahArabic-math	Other
doublestrucktahArabic-math	Other
doublestruckyehArabic-math	Other
doublestrucklamArabic-math	Other
doublestruckmeemArabic-math	Other
doublestrucknoonArabic-math	Other
doublestruckseenArabic-math	Other
doublestruckainArabic-math	Other
doublestruckfehArabic-math	Other
doublestrucksadArabic-math	Other
doublestruckqafArabic-math	Other
doublestruckrehArabic-math	Other
doublestrucksheenArabic-math	Other
doublestrucktehArabic-math	Other
doublestruckthehArabic-math	Other
doublestruckkhahArabic-math	Other
doublestruckthalArabic-math	Other
doublestruckdadArabic-math	Other
doublestruckzahArabic-math	Other
doublestruckghainArabic-math	Other
OperatorMeemWithHahWithTatweelArabic-math	Other
OperatorHahWithDalArabic-math	Other
u1D6DB.mir	Other
u1D715.mir	Other
u1D74F.mir	Other
u1D789.mir	Other
u1D7C3.mir	Other
g1	Other
g2	Other
g568	Other
g569	Other
g570	Other
g887	Other
g888	Other
g889	Other
g890	Other
g891	Other
g892	Other
g893	Other
g894	Other
g938	Other
cyrillichookleft	Other
cyrillicbighookUC	Other
cyrillicbighookLC	Other
NULL	Other
